亜 : ｜ 一 口
唖 : ｜ 一 口
娃 : 女 土
阿 : 一 口 亅 ⻖
哀 : 衣 口 亠
愛 : 心 爪 冖 夂
挨 : 矢 厶 心 乞
姶 : 一 口 女 ㅅ
逢 : ｜ ⻌ 二 夂
葵 : 人 大 二 癶 ⺾ ノ
茜 : 西 ⺾
穐 : 禾 亀 乙 勹 田
悪 : ｜ 一 口 心
握 : 至 土 厶 尸 心
渥 : 至 ⺡ 土 厶 尸
旭 : 日 九
葦 : 口 ⺾ 韋
芦 : 戸 ⺾ 一 尸
鯵 : 魚 大 田 厶 彡 ⺣
梓 : 十 辛 木 立
圧 : 土 厂
斡 : 十 斗 日 ㅅ
扱 : 心 及
宛 : 夕 卩 宀
姐 : 女 目
虻 : 虫 亡 亠
飴 : 口 食 厶
絢 : 糸 幺 小 日 勹
綾 : 糸 幺 小 土 儿 夂
鮎 : 魚 口 田 卜 ⺣
或 : 口 戈 一
粟 : 西 米
袷 : 口 ⻂ ㅅ 一
安 : 女 宀
庵 : 田 广 大
按 : 女 宀 心
暗 : 音 日 立
案 : 女 木 宀
闇 : 音 日 門 立
鞍 : 女 宀 革
杏 : 口 木
以 : ｜ 人 丶
伊 : ｜ ヨ ⺅
位 : ⺅ 立
依 : 衣 ⺅ 亠
偉 : ⺅ 口 韋
囲 : 囗 井
夷 : ノ 一 弓 大
委 : 禾 女
威 : ノ 女 戈 厂
尉 : 示 二 小 寸 尸
惟 : ⺖ 隹
意 : 音 心 日 立
慰 : 示 二 小 心 寸 尸
易 : 日 勿 勹 ノ
椅 : 口 大 木 一 亅
為 : ノ ⺣ ユ 丶 丷 勹
畏 : 衣 一 田
異 : 一 田 ハ 井
移 : 禾 夕
維 : 糸 幺 小 隹
緯 : 口 糸 幺 小 韋
胃 : 月 田
萎 : 禾 女 ⺾
衣 : 衣 亠
謂 : 月 言 田
違 : 口 ⻌ 韋
遺 : 一 貝 目 ハ ⻌ 口 ｜
医 : 矢 匚 乞
井 : ｜ ノ 一 二 井
亥 : 人 亠 ノ 丶
域 : 口 土 戈
育 : 月 亠 厶
郁 : ノ 一 月 ⻏
磯 : ノ 口 石 戈 幺 丶
一 : 一
壱 : 士 冖 匕
溢 : 皿 ⺡ ⺌ ハ 丷
逸 : ノ ⻌ 免 儿 勹
稲 : ｜ 禾 爪 日
茨 : 欠 冫 ⺾
芋 : 一 ⺾ 干
鰯 : 弓 魚 田 冫 ⺣
允 : 厶 儿
印 : ｜ 卩
咽 : 口 大 囗
員 : 貝 目 ハ 口
因 : 大 囗
姻 : 女 大 囗
引 : ｜ 弓
飲 : 欠 食
淫 : ノ 士 ⺡ 爪 王
胤 : 月 儿 幺
蔭 : 二 ㅅ 厶 ⺾ ⻖ 一
院 : 二 儿 宀 ⻖ 元
陰 : 二 ㅅ 厶 ⻖ 一
隠 : ノ ヨ ⺌ 心 ⻖
韻 : 音 貝 目 ハ 口 日 立
吋 : 口 寸
右 : ノ 一 口
宇 : 干 亅 宀
烏 : 鳥 ⺣
羽 : 羽 冫
迂 : 干 ⻌ 二 亅
雨 : 雨
卯 : 卩
鵜 : ｜ ノ 弓 鳥 丷 ⺣
窺 : 見 ハ 宀 一 大 穴 二 儿
丑 : ｜ ノ 一
碓 : 口 石 隹
臼 : 臼
渦 : ｜ 口 ⺡ 冂
嘘 : 口 卜 匕 厂 虍
唄 : 貝 目 ハ 口
欝 : 艮 寸 ⺲ 木
蔚 : 示 二 小 寸 尸 ⺾
鰻 : 魚 田 日 ⺲ 又 ⺣
姥 : 女 ⺹ 匕
厩 : 牙 艮 儿 厂
浦 : 十 ⺡ 用 丶
瓜 : 瓜 厶
閏 : 王 門
噂 : 口 寸 西 丷
云 : 一 二 厶
運 : ⻌ 車 冖
雲 : 一 雨 二 厶
荏 : ⺅ 士 ⺾
餌 : 艮 耳 食
叡 : ハ 卜 又 目 冖
営 : 口 ⺌ 冖 ノ
嬰 : 貝 目 ハ 女
影 : 口 小 日 亠 彡
映 : ノ 日 大 冖
曳 : 乙 日
栄 : ⺌ 木 冖
永 : 水 丶
泳 : ⺡ 水 丶
洩 : ノ 乙 ⺡ 日
瑛 : ノ 王 ⺾ 大 冖
盈 : ノ 一 皿 又
穎 : 禾 貝 目 ハ 頁 匕
頴 : 貝 目 ハ 示 二 小 頁 匕
英 : ノ ⺾ 大 冖
衛 : 口 行 彳 韋
詠 : 言 水 丶
鋭 : 金 口 丷 ㅅ 儿
液 : ⺅ ⺡ 亠 攵 夕 乞
疫 : 殳 ⽧ 几 又
益 : 一 皿 ハ 丷
駅 : 馬 尸 ⺣ 丶
悦 : 口 丷 ⺖ 儿
謁 : 言 日 勹 匕
越 : 走 土 戈
閲 : 口 丷 門 儿
榎 : 一 自 木 目 夂
厭 : 月 犬 日 厂
円 : 冂 亠 一 ｜
園 : 衣 口 土 囗
堰 : 女 土 日 匚
奄 : 乙 大 日 奄
宴 : 女 日 宀
延 : 一 止 廴
怨 : 心 夕 卩
掩 : 乙 大 日 心 奄
援 : ノ 一 爪 又 心
沿 : 口 ⺡ ハ
演 : ⺡ 田 ハ 宀 一
炎 : 火
焔 : ｜ 火 日 勹
煙 : 火 西 土
燕 : 口 匕 ⺣ 爿 ⺾
猿 : 衣 口 土 ⺨
縁 : ヨ 糸 幺 小 豕
艶 : ｜ 口 色 豆 日 丷 勹
苑 : 夕 卩 ⺾
薗 : 衣 口 土 囗 ⺾
遠 : 衣 口 ⻌ 土
鉛 : 金 口 丷 ハ
鴛 : 鳥 夕 卩 ⺣
塩 : 口 皿 土 ノ 一 人 乞
於 : 方 ㅅ
汚 : 一 ⺡ 勹 二
甥 : 生 田 力
凹 : 凵
央 : ノ 一 大 冖
奥 : 大 米 冂
往 : 王 丶 彳
応 : 心 广
押 : ｜ 日 心 田
旺 : 王 日
横 : ｜ 黄 田 二 日 ハ 木 廾
欧 : 欠 匚 ノ 丶
殴 : ノ 丶 匚 殳 几 又
王 : 王
翁 : 羽 ハ 冫 厶
襖 : ⻂ 大 米 冂 釆
鴬 : ⺌ 鳥 冖 ⺣
鴎 : 鳥 匚 ⺣ ノ 丶
黄 : 黄 田 ハ
岡 : 丷 冂 一 山 岡
沖 : ｜ ⺡ 口
荻 : 火 ⺨ ⺾
億 : 音 ⺅ 心 日 立
屋 : 至 土 厶 尸
憶 : 音 心 日 ⺖ 立
臆 : 音 月 心 日 立
桶 : 木 用 マ
牡 : 牛 土
乙 : 乙
俺 : 乙 ⺅ 大 奄
卸 : ノ 止 卩 乞
恩 : 心 大 囗
温 : 皿 ⺡ 日
穏 : ヨ 禾 心 爪
音 : 音 日 立
下 : ｜ 一 卜
⺅ : ⺅ 匕
仮 : ⺅ 又 厂
何 : ⺅ 口 亅 一
伽 : ⺅ 口 力
価 : ⺅ 西
佳 : ⺅ 土
加 : 口 力
可 : 一 口 亅
嘉 : 口 士 力
夏 : 一 自 夂 目
嫁 : 女 宀 豕
家 : 宀 豕
寡 : 一 自 刀 ハ 宀
科 : 禾 斗
暇 : 日 又
果 : ｜ 田 木
架 : 口 木 力
歌 : 一 欠 口 亅
河 : 口 ⺡ 亅 一
火 : 火
珂 : 王 口 亅 一
禍 : 口 ⺭ 冂
禾 : 禾 木 ノ
稼 : 禾 宀 豕
箇 : 口 十 竹 囗 乞
花 : ⺅ 匕 ⺾
苛 : 一 口 亅 ⺾
茄 : 口 力 ⺾
荷 : ⺅ 口 亅 ⺾ 一
華 : ｜ 一 ⺾
菓 : 田 木 ⺾
蝦 : 虫 又 口
課 : 言 田 木
嘩 : 一 口 ⺾ ｜
貨 : ⺅ 貝 目 ハ 匕
迦 : 口 ⻌ 力
過 : 口 ⻌ 冂
霞 : 雨 又
蚊 : 虫 文
俄 : ⺅ 亅 戈 手
峨 : 山 亅 戈 手
我 : 亅 戈 手
牙 : 牙
画 : 一 田 凵
臥 : 臣 人
芽 : 牙 ⺾
蛾 : 虫 亅 戈 手
賀 : 貝 目 ハ 口 力
雅 : 牙 隹
餓 : 食 亅 戈 手
駕 : 口 馬 力 ⺣
介 : ハ ㅅ
会 : 二 ㅅ 厶
解 : 角 牛 刀
回 : 口 囗
塊 : 鬼 田 土 儿 匕 厶
壊 : 衣 十 土 ⺲ 亠
廻 : 口 囗 廴
快 : 人 大 二 ⺖ ユ
怪 : 土 ⺖ 又
悔 : 母 ⺖ 毋 ノ 一 人 乞
恢 : 火 厂 ⺖
懐 : 衣 十 ⺲ ⺖ 亠
戒 : 廾 戈
拐 : 口 刀 心
改 : 已 攵 乞
魁 : 鬼 田 斗 儿 厶 匕
晦 : 日 母 毋 乞
械 : 木 廾 戈
海 : ⺡ 母 毋 乞
灰 : 火 厂
界 : 田 ㅅ 儿
皆 : 白 比
絵 : 糸 幺 小 二 ㅅ 厶
芥 : ㅅ ⺾ 儿
蟹 : 角 牛 虫 刀
開 : 一 門 廾 二 ノ
階 : 白 比 ⻖
貝 : 貝 目 ハ
凱 : 口 山 豆 丷 几
劾 : 人 力 亠 ノ 丶
外 : 卜 夕
咳 : 口 人 亠 ノ 丶
害 : 口 土 亠 宀 二
崖 : 山 土 厂
慨 : 牙 艮 ⺖
概 : 牙 艮 木
涯 : ⺡ 土 厂
碍 : 口 寸 石 日 一
蓋 : 皿 土 厶 ⺾
街 : 行 土 彳
該 : 言 人 亠 ノ 丶
鎧 : 金 口 山 豆 丷
骸 : 月 骨 人 亠 冂 冖 ノ 丶
浬 : ⺡ 里 田 土
馨 : 禾 香 士 日 又 几 殳 尸
蛙 : 虫 土
垣 : 一 土 日
柿 : ｜ 巾 木 亠 冂
蛎 : 斤 虫 厂
鈎 : 金 勹 厶
劃 : 一 ⺉ 田 聿
嚇 : 口 赤 土
各 : 口 夂 攵
廓 : 口 子 ⻏ 亅 亠 广
拡 : 厶 广 心
撹 : 見 ⺌ 冖 心
格 : 口 木 夂
核 : 人 木 亠 ノ 丶
殻 : 士 冖 殳 几 又
獲 : ⺨ 又 ⺾ 隹
確 : 口 石 宀 隹
穫 : 禾 又 ⺾ 隹
覚 : 見 ⺌ 冖
角 : 角 勹 月 ｜
赫 : 赤 土
較 : 車 父 亠
郭 : 口 ⻏ 亅 亠 子
閣 : 口 門 夂
隔 : 一 口 儿 冂 ⻖ 鬲
革 : 革 廾 口 十
学 : 子 ⺌ 冖
岳 : 山 斤 一
楽 : 白 木 冫
額 : 貝 目 ハ 口 頁 夂 宀
顎 : 貝 目 ハ 口 頁 二 勹
掛 : 土 卜 心
笠 : 竹 立 乞
樫 : 臣 土 又 木
橿 : 一 田 木
梶 : 毛 木 尸
鰍 : 火 禾 魚 田 ⺣
潟 : 臼 ⺡ 勹 ⺣
割 : ⺉ 口 土 宀 亠 二
喝 : 口 日 勹 匕
恰 : 口 ⺖ ㅅ 一
括 : ノ 口 十 舌 心
活 : ノ 口 十 ⺡ 舌
渇 : ⺡ 日 勹 匕
滑 : 月 骨 ⺡ 冂 冖
葛 : 日 勹 匕 ⺾
褐 : ⻂ 日 勹 匕
轄 : 口 車 土 亠 宀 二
且 : 一 目
鰹 : 魚 臣 田 土 又 ⺣
叶 : 口 十
椛 : ⺅ 木 匕 ⺾
樺 : ｜ 一 木 ⺾
鞄 : 革 勹 已
株 : 牛 木
兜 : 白 儿
竃 : 亀 穴 土 宀 儿 乙 勹 田
蒲 : ⺡ 用 丶 ⺾ 十
釜 : 一 干 丷 父 王 丶 ノ 金
鎌 : 金 王 丶 ノ ヨ 丷 ハ
噛 : 口 止 歯 米
鴨 : ｜ 鳥 日 ⺣ 田
栢 : 一 白 木
茅 : 矛 ⺾
萱 : 一 日 宀 ⺾
粥 : 弓 米
⺉ : ⺉
苅 : ⺉ ⺾
瓦 : 瓦 一
乾 : 乙 十 日 ノ 一 人 乞
侃 : ⺅ 口 川
冠 : 寸 儿 冖 元
寒 : 一 ハ 宀 丶 井
刊 : ⺉ 干
勘 : 力 匚 甘 儿
勧 : ノ 力 隹 矢 乞
巻 : 大 二 丷 已
喚 : 口 大 儿 冂 勹
堪 : 土 儿 匚 甘
姦 : 女
完 : 二 儿 宀 元
官 : 口 宀 ｜
寛 : 見 宀 ⺾
干 : 干 十 一
幹 : 干 十 日 ㅅ
患 : ｜ 口 心
感 : ノ 口 心 戈
慣 : 貝 目 ハ 母 ⺖ 毋
憾 : ノ 口 心 ⺖ 戈
換 : 大 儿 冂 勹 心
敢 : 耳 攵 乞
柑 : 日 木 甘
桓 : 一 日 木
棺 : 口 木 宀 ｜
款 : 欠 士 示 二 小
歓 : 欠 隹 矢 乞
汗 : 干 ⺡
漢 : ⺡ ⺾ 口 一 大 二
澗 : ⺡ 日 門
潅 : ⺡ 隹 矢 乞
環 : 衣 王 口 ⺲ 一
甘 : 甘
監 : 皿 臣 二 乞
看 : ノ 一 手 二 目
竿 : 干 竹 乞
管 : 口 竹 宀 ｜ 乞
簡 : 竹 日 門 乞
緩 : 糸 幺 小 爪 一 ノ 又
缶 : 缶 凵 山
翰 : 羽 十 日 ㅅ 冫
肝 : 干 月
艦 : 皿 舟 臣 二 乞
莞 : 二 儿 宀 ⺾ 元
観 : 見 隹 矢 乞
諌 : ｜ 言 日 木 田
貫 : 貝 目 ハ 母 毋
還 : 衣 口 ⻌ ⺲ 一
鑑 : 金 皿 臣 二 乞
間 : 日 門
閑 : 木 門
関 : 人 大 二 ハ 門 丷 一
陥 : ｜ 日 勹 ⻖
韓 : 十 日 韋 口
館 : 口 食 宀 ｜
舘 : 干 口 ㅅ 宀 ｜
丸 : 九 丶
含 : 口 ㅅ 一
岸 : 干 山 厂
巌 : 山 耳 ⺌ 厂 攵 乞
玩 : 王 儿 二 元
癌 : 口 山 ⽧ 品
眼 : 艮 目
岩 : 口 山 石
翫 : 羽 白 儿 冫 元
贋 : ⺅ 貝 目 ハ 厂 隹
雁 : ⺅ 厂 隹
頑 : 貝 目 ハ 頁 儿 二 元
顔 : 貝 目 ハ 頁 立 亠 厂 彡
願 : 貝 目 ハ 小 白 頁 厂
企 : 止 ㅅ
伎 : ⺅ 支 又 十
危 : 勹 厂 卩
喜 : 口 士 豆 丷
器 : 口 大
基 : 一 甘 土 ハ
奇 : 一 口 大 亅
嬉 : 口 士 女 豆 丷
寄 : 一 口 大 亅 宀
岐 : 山 支 又 十
希 : ノ 一 巾
幾 : ノ 幺 戈 丶
忌 : 心 已
揮 : 車 冖 心
机 : 木 几
旗 : 甘 ハ 方 乞
既 : 牙 艮
期 : 甘 月 ハ
棋 : 甘 ハ 木
棄 : 一 木 亠 凵 厶
機 : ノ 木 丶 幺 戈
帰 : ヨ ⺉ 巾 冖
毅 : 立 亠 殳 豕 几 又
気 : 气 丶 ノ 乞
汽 : ⺡ 气 乞
畿 : 田 幺 戈 丶 ノ
祈 : 斤 ⺭
季 : 禾 子
稀 : ノ 一 禾 巾 丶
紀 : 糸 幺 小 已
徽 : 山 糸 幺 小 攵 彳
規 : 見 土 人 二 大
記 : 言 已
貴 : ｜ 一 貝 目 ハ 口
起 : 走 土 已
軌 : 車 九
輝 : 車 ⺌ 儿 冖 一
飢 : 食 几
騎 : 口 大 馬 亅 一 ⺣
鬼 : 鬼 田 儿 匕 厶
亀 : 亀 田 勹 乙
偽 : ⺅ 丶 ⺣ ユ ノ 丷 勹
儀 : 一 王 ⺅ 丷 羊 亅 戈 手
妓 : 支 女 又 十
宜 : 一 目 宀
戯 : 卜 匕 厂 戈 虍
技 : 支 心 又 十
擬 : 疋 矢 匕 心 マ 乞
欺 : 甘 欠 ハ
犠 : 一 王 牛 丷 羊 亅 戈 手
疑 : 疋 矢 匕 マ 乞
祇 : 氏 ⺭
義 : 一 王 丷 羊 亅 戈 手
蟻 : 一 王 虫 丷 羊 亅 戈 手
誼 : 一 言 目 宀
議 : 一 王 言 丷 羊 亅 戈 手
掬 : 米 勹 心
菊 : 米 勹 ⺾
鞠 : 革 米 勹
吉 : 口 士
吃 : 乙 口 乞 乞
喫 : 口 大 土 刀 亠 二
桔 : 口 士 木
橘 : 口 矛 木 儿 冂
詰 : 言 口 士
砧 : 口 石 卜
杵 : ノ 干 木 十 乞
黍 : 禾 黍 水
却 : 土 卩 厶
客 : 口 夂 宀
脚 : 月 土 卩 厶
虐 : 卜 匕 匚 厂 虍
逆 : ⻌ 丷 屮
丘 : 一 斤
久 : ノ 入 久
仇 : ⺅ 九
休 : ⺅ 木
及 : 丶 及 乃 ノ
吸 : ノ 口 及
宮 : 口 宀 ノ
弓 : 弓
急 : ヨ 心 勹
救 : 水 丶 攵 乞
朽 : 一 木 勹
求 : 一 水 丶
汲 : ノ ⺡ 及
泣 : ⺡ 立
灸 : 久 火
球 : 王 水 丶
究 : 穴 九 儿 宀
窮 : 弓 穴 身 儿 宀
笈 : ノ 竹 及 乞
級 : ノ 糸 幺 小 及
糾 : ｜ 糸 幺 小 十
給 : 口 糸 幺 小 ㅅ 一
旧 : ｜ 日
牛 : 牛
去 : 土 厶
居 : 口 十 尸
巨 : 匚 巨
拒 : 匚 心 巨
拠 : 几 夂 心
挙 : 手 ⺌ ハ
渠 : ⺡ 木 匚 巨
虚 : 一 卜 匕 厂 虍
許 : ノ 干 言 十 乞
距 : 口 足 匚 巨 止
鋸 : 金 口 十 尸
漁 : 魚 ⺡ 田 ⺣
禦 : 止 示 二 小 卩 彳 乞
魚 : 魚 田 ⺣
亨 : 口 亠 一 亅
享 : 口 子 亠
京 : 口 小 亠
供 : ｜ 一 ⺅ 二 ハ
侠 : ⺅ 人 大 二 丷 亠
僑 : ノ ⺅ 口 冂 大
兇 : 儿 凵 丶 ノ
競 : 口 立 儿
共 : ハ ｜ 一 二
凶 : 凵 丶 ノ
協 : 十 力
匡 : 王 匚
卿 : 艮 卩
叫 : ｜ 口 十
喬 : ノ 口 冂 大
境 : 音 土 日 立 儿
峡 : 山 人 大 二 丷 亠
強 : 弓 虫 厶
彊 : 一 弓 田
怯 : 土 ⺖ 厶
恐 : 工 心 丶 几
恭 : 心 ハ 井
挟 : 人 大 二 丷 丶 亠 心
教 : 子 ⺹ 攵 乞
橋 : ノ 口 木 冂
況 : 口 ⺡ 儿
狂 : 王 ⺨
狭 : 人 大 二 丷 ⺨ 丶 亠
矯 : ノ 口 矢 冂 大 乞
胸 : 月 凵 勹 ノ 丶
脅 : 月 力
興 : 臼 口 ハ 冂 一
蕎 : ノ 口 冂 ⺾ 大
郷 : 艮 ⻏ 幺
鏡 : 音 金 日 立 儿
響 : 音 艮 日 ⻏ 立 幺
饗 : 艮 食 ⻏ 幺
驚 : 口 馬 勹 夂 ⺾ 攵 ⺣ 乞
仰 : ⺅ 卩
凝 : 矢 冫 匕 マ 疋 乞
尭 : 十 儿 廾 一
暁 : 十 日 儿 廾
業 : ｜ 一 王 丷 木 羊 耒
局 : 口 尸
曲 : ｜ 日
極 : 口 又 木 一
玉 : 王 丶
桐 : 口 木 冂 一
粁 : 干 米 十
僅 : ⺅ 土 ⺾ 口 二 一
勤 : 土 力 ⺾ 口 二 一
均 : 土 冫 勹 二
巾 : 巾 冂 ｜
錦 : 巾 金 白
斤 : 斤
欣 : 斤 欠
欽 : 金 欠
琴 : 王 ㅅ 一
禁 : 示 二 小 木
禽 : ㅅ 亠 冂 凵 厶 ⽱ 丶 ノ
筋 : 月 竹 力 乞
緊 : 糸 幺 小 臣 又
芹 : 斤 ⺾
菌 : 禾 囗 ⺾
衿 : ⻂ ㅅ 一
襟 : 示 二 小 ⻂ 木
謹 : 言 土 ⺾ 口 口 二
近 : 斤 ⻌
金 : 金 王 ハ ㅅ 丷
吟 : 口 ㅅ 一
銀 : 金 艮
九 : 九
倶 : ⺅ ハ 目 一
句 : 口 勹
区 : 匚 丶 ノ
狗 : 口 ⺨ 勹
玖 : 久 王
矩 : 矢 巨 乞
苦 : 口 十 ⺾
躯 : 身 匚 丶 ノ
駆 : 馬 匚 丶 ノ ⺣ ⺣
駈 : 斤 馬 ⺣ 一
駒 : 口 馬 勹 ⺣
具 : 一 ハ 目
愚 : 心 田 冂 厶 ⽱
虞 : 口 ハ 卜 匕 厂 虍
喰 : 口 食
空 : 穴 工 儿 宀
偶 : ⺅ 田 冂 厶 ⽱
寓 : 田 冂 厶 宀 ⽱
遇 : ⻌ 田 冂 厶 ⽱
隅 : 田 日 冂 厶 ⽱ ⻖
串 : ｜ 口
櫛 : 艮 竹 木 卩 乞
釧 : 金 川
屑 : 月 ⺌ 尸
屈 : ｜ 山 尸
掘 : ｜ 山 尸 心
窟 : ｜ 穴 山 儿 宀 尸
沓 : 水 日
靴 : ⺅ 革 匕
轡 : 口 糸 幺 小 車
窪 : 穴 ⺡ 土 儿 宀
熊 : 月 匕 厶 ⺣
隈 : 衣 田 ⻖
粂 : 久 米
栗 : 西 木
繰 : 口 糸 幺 小 木 品
桑 : 又 木
鍬 : 火 禾 金
勲 : ｜ 力 ⺣ 日 一 ノ
君 : 一 口 ノ ヨ
薫 : ｜ ⺣ ⺾ 日 ノ 一
訓 : 言 川
群 : 一 王 口 丷 羊 ノ ヨ
軍 : 車 冖
郡 : 一 口 ⻏ ノ ヨ
卦 : 土 卜
袈 : 衣 口 力 亠
祁 : ⻏ ⺭
係 : ノ ⺅ 糸 幺 小
傾 : ⺅ 貝 目 ハ 頁 匕
刑 : ⺉ 廾 ノ 二 一
兄 : 口 儿
啓 : 戸 口 攵 一 尸 乞
圭 : 土
珪 : 王 土
型 : ⺉ 土 廾 ノ 二 一
契 : 大 土 刀 亠 二
形 : 廾 彡 ノ 二 一
径 : 土 又 彳
恵 : 一 心 田
慶 : 心 冖 夂 广
慧 : ヨ 心 ｜ 一
憩 : 口 自 心 舌 目
掲 : 日 勹 匕 心
携 : ノ 心 隹 乃
敬 : 口 勹 攵 ⺾ 乞
景 : 口 小 日 亠
桂 : 土 木
渓 : ⺡ 人 爪 土 二 大
畦 : 田 土
稽 : 禾 日 匕 尤
系 : ノ 糸 幺 小
経 : 糸 幺 小 土 又
継 : ｜ 糸 幺 小 米
繋 : 糸 幺 小 車 殳 几 又
罫 : 土 ⺲ 卜
茎 : 土 又 ⺾
荊 : ⺉ 廾 ⺾ ノ 二 一
蛍 : ⺌ 虫 冖
計 : 言 十
詣 : 言 日 匕
警 : 言 口 勹 夂 ⺾ 攵 乞
軽 : 車 土 又
頚 : 貝 目 ハ 土 頁 又
鶏 : 人 爪 土 大 鳥 ⺣ 二
芸 : 二 厶 ⺾
迎 : ⻌ 卩
鯨 : 魚 口 小 田 亠 ⺣
劇 : ⺉ 卜 匕 厂 虍 豕
戟 : 十 日 戈
撃 : 車 手 殳 几 又
激 : ⺡ 白 方 攵 乞
隙 : 小 日 ⻖
桁 : 行 木 彳
傑 : ⺅ 舛 木 夕
欠 : 欠 勹 人
決 : ⺡ 人 大 二 ユ
潔 : 糸 幺 小 ⺡ 土 刀 亠 二
穴 : 穴 ハ 宀 儿
結 : 口 士 糸 幺 小
血 : 血 皿
訣 : 言 人 大 二 ユ
月 : 月
件 : ⺅ 牛
倹 : ⺅ 口 人 ㅅ 一
倦 : ⺅ 已 大 二 丷 卩 ハ
健 : ⺅ 廴 聿
兼 : ｜ ヨ 一 ハ 丷
券 : 一 人 大 刀 二 丷
剣 : ⺉ 口 人 ㅅ
喧 : 一 口 日 宀
圏 : 一 人 大 二 丷 囗 已
堅 : 臣 土 又
嫌 : ｜ ヨ 女 ハ 丷
建 : 廴 聿
憲 : 心 土 ⺲ 亠 宀 二
懸 : ノ 糸 幺 小 心 目
拳 : 一 手 丷 大 二
捲 : 一 丷 已 心 大 二
検 : 口 人 木 ㅅ
権 : 矢 木 隹 乞
牽 : 亠 冖 厶 牛
犬 : 犬 大 丶
献 : 干 犬 十 丷 冂
研 : ｜ 口 石 亅 廾 ノ 二 一
硯 : 見 口 石
絹 : 月 口 糸 幺 小
県 : 小 目
肩 : 月 戸 一 尸
見 : 見 目 儿
謙 : ｜ ヨ 言 ハ 丷
賢 : 貝 目 ハ 臣 又
軒 : 干 車
遣 : ｜ 一 口 ⻌
鍵 : 金 廴 聿
険 : 口 人 ㅅ ⻖
顕 : 貝 目 ハ 日 頁
験 : 口 人 馬 ㅅ ⺣
鹸 : 口 十 人 ㅅ 囗 鹵
元 : 二 儿 元
原 : 小 白 厂
厳 : 耳 ⺌ 厂 攵 乞
幻 : 幺
弦 : 弓 玄 亠 幺
減 : 口 ⺡ 亅 戈
源 : ⺡ 小 白 厂
玄 : 玄 亠 幺
現 : 王 見
絃 : 玄 糸 幺 小 亠
舷 : 玄 舟 亠 幺
言 : 言
諺 : 言 丷 立 亅 亠 彡
限 : 艮 ⻖
乎 : ノ 一 丷 亅
個 : ⺅ 口 十 囗
古 : 口 十
呼 : ノ 口 丷 亅
固 : 口 十 囗
姑 : 口 十 女
孤 : 瓜 子
己 : 已
庫 : 車 广
弧 : 瓜 弓
戸 : 戸 一 尸
故 : 口 十 攵 乞
枯 : 口 十 木
湖 : 月 口 十 ⺡
狐 : 瓜 ⺨
糊 : 月 口 十 米
袴 : ⻂ 大 二 勹
股 : 月 殳 几 又
胡 : 月 口 十
菰 : 瓜 子 ⺾
虎 : 卜 儿 匕 厂 虍
誇 : 言 大 二 勹
跨 : 口 足 大 二 勹 止
鈷 : 金 口 十
雇 : 戸 隹 一 尸
顧 : 貝 目 ハ 戸 頁 隹 一 尸
鼓 : 口 士 支 豆 丷 又 十 鼓
五 : 五
互 : ヨ 一 彑
伍 : ⺅ 五
午 : ノ 干 十 乞
呉 : 口 ハ
吾 : 口 五
娯 : 口 女 ハ
後 : 夂 幺 彳
御 : ノ 止 卩 彳 乞
悟 : 口 ⺖ 五
梧 : 口 木 五
檎 : 木 ㅅ 亠 冂 厶 ⽱
瑚 : 王 月 口 十
碁 : 一 口 石 ハ 甘
語 : 言 口 五
誤 : 言 口 ハ
護 : 言 又 ⺾ 隹
醐 : 月 口 十 酉
乞 : ノ 一 乙 人 乞
鯉 : 魚 田 里 ⺣
交 : 父 亠
佼 : ⺅ 父 亠
侯 : ⺅ 矢 ユ 乞
候 : ｜ ⺅ 矢 ユ 乞
倖 : ⺅ 十 辛 立 亠
光 : 一 ⺌ 儿
公 : ハ 厶
功 : 工 力
効 : 父 力 亠
勾 : 勹 厶
厚 : 子 日 厂
口 : 囗 口
向 : 口 冂
后 : ノ 一 斤 口 亅 厂
喉 : ⺅ 口 矢 乞
坑 : 土 亠 几
垢 : ノ 斤 口 土 亅 厂
好 : 子 女
孔 : 乙 子
孝 : 子 ⺹
宏 : ノ 一 厶 宀
工 : 工
巧 : 工 一 勹
巷 : ハ 已 井
幸 : 十 辛 立 亠
広 : 厶 广
庚 : 人 广 ヨ
康 : ヨ 水 广 隶
弘 : 弓 厶
恒 : 一 日 ⺖
慌 : 川 ⺖ ⺾ 亡
抗 : 亠 几 心
拘 : 口 勹 心
控 : 穴 工 儿 宀 心
攻 : 工 攵 乞
昂 : 日 卩
晃 : 一 ⺌ 日 儿
更 : ノ 一 日 田
杭 : 木 亠 几
校 : 父 木 亠
梗 : ノ 一 日 木 田
構 : 木 冂 一 十
江 : 工 ⺡
洪 : ｜ 一 ⺡ 二 ハ
浩 : ノ 口 ⺡ 土
港 : ⺡ ハ 已 井
溝 : ⺡ 冂 一 十 ｜
甲 : ｜ 日 田
皇 : 王 白
硬 : ノ 一 口 石 日 田
稿 : 禾 口 高 亠 冂
糠 : ヨ 水 米 广 隶
紅 : 工 糸 幺 小
紘 : ノ 一 糸 幺 小 厶
絞 : 糸 幺 小 父 亠
綱 : 糸 幺 小 丷 冂 山 一 岡
耕 : ｜ 土 ハ 木 亅 耒 井 ノ
考 : ⺹ 勹
肯 : 月 止
肱 : ノ 一 月 厶
腔 : 穴 月 工 儿 宀
膏 : 月 口 亠 冖 高
航 : 舟 亠 几
荒 : 川 ⺾ 亡
行 : 行 彳
衡 : 行 大 田 彳 勹
講 : 言 冂 一 十
貢 : 貝 目 ハ 工
購 : ｜ 一 貝 目 ハ 冂 十
郊 : 父 ⻏ 亠
酵 : 子 酉 ⺹
鉱 : 金 厶 广
砿 : 口 石 厶 广
鋼 : 金 丷 冂 山 岡
閤 : 口 門 ㅅ 一
降 : 夂 ⻖ 十
項 : 貝 目 ハ 工 頁
香 : 禾 香 日
高 : 口 高 亠 冂
鴻 : 工 ⺡ 鳥 ⺣
剛 : ⺉ 丷 冂 岡 山
劫 : 土 力 厶
号 : 一 口 勹
合 : 口 ㅅ 一
壕 : 口 土 亠 冖 豕
拷 : ⺹ 心
濠 : 口 ⺡ 亠 冖 豕
豪 : 口 亠 冖 豕
轟 : 車
麹 : 土 麦 米 亠 勹 夂 二
克 : 口 十 儿
刻 : ⺉ 亠 人 ノ 丶
告 : ノ 口 土
国 : 王 囗 丶
穀 : 禾 士 冖 殳 几 又
酷 : ノ 口 土 酉
鵠 : ノ 口 鳥 土 ⺣
黒 : 黒 里 ⺣
獄 : 言 ⺨ 犬
漉 : 鹿 ⺡ 比 广
腰 : 月 女 西
甑 : 瓦 田 日 丷
忽 : 勿 心 勹 ノ
惚 : 心 ⺖ 勿 勿
骨 : 月 冖 冂 骨
狛 : 白 ⺨
⻌ : ⻌ 入
此 : 止 匕
頃 : 貝 目 ハ 頁 匕
今 : ㅅ 一
困 : 木 囗
坤 : ｜ 土 日 田
墾 : 艮 爪 土 ⺨ 豸
婚 : 氏 女 日
恨 : 艮 ⺖
懇 : 艮 心 爪 ⺨ 豸
昏 : 氏 日
昆 : 日 比
根 : 艮 木
梱 : 木 囗
混 : ⺡ 日 比
痕 : 艮 ⽧
紺 : 甘 糸 幺 小
艮 : 艮
魂 : 鬼 田 二 儿 匕 厶
些 : 止 二 匕
佐 : ノ 一 ⺅ 工
叉 : 又 丶
唆 : 口 儿 厶 夂
嵯 : ノ 王 工 山 丷 羊
左 : ノ 一 工
差 : ノ 王 工 丷 羊
査 : 一 木 目
沙 : ノ ⺡ 小
瑳 : ノ 王 工 丷 羊
砂 : ノ 口 小 石
詐 : ｜ ノ 言
鎖 : 貝 目 ハ 金 ⺌
裟 : ノ 衣 ⺡ 小 亠
坐 : ｜ 土 人
座 : ｜ 土 人 广
挫 : ｜ 土 人 心
債 : ⺅ 貝 目 ハ 土 亠 二
催 : ⺅ 山 隹
再 : ｜ 一 冂 王
最 : 一 耳 日 又
哉 : 口 土 戈
塞 : 一 土 ハ 宀
妻 : ｜ ヨ 一 女
宰 : 十 辛 立 宀
彩 : 爪 木 彡
才 : ノ 一 亅
採 : 爪 木 心
栽 : 土 木 戈
歳 : ノ 止 小 戈
済 : ｜ ノ ⺡ 文 廾 斉
災 : 火 巛
采 : 爪 木
犀 : 尸 ｜ 二 十 ノ 一
砕 : ノ 口 十 石 九
砦 : 口 止 石 匕
祭 : 示 二 小 ㅅ 癶
斎 : ｜ ノ 文 廾 斉 示 二 小
細 : 糸 幺 小 田
菜 : 爪 木 ⺾
裁 : 土 亠 厶 戈 衣
載 : 車 土 戈
際 : ノ 示 二 小 癶 ⻖
剤 : ｜ ノ ⺉ 文 廾 斉
在 : ｜ ノ 一 土
材 : ノ 一 木 亅
罪 : ⺲ 非
財 : ノ 一 貝 目 ハ 亅
冴 : 牙 冫
坂 : 土 又 厂
阪 : 又 厂 ⻖
堺 : 田 土 ハ 儿
榊 : ｜ 日 木 ⺭ 田
肴 : ノ 一 月 丶
咲 : 口 人 大 二 丷 一
崎 : 口 山 大 ｜ 一
埼 : 口 大 土 ｜ 一
碕 : 口 石 大 ｜ 一
鷺 : 口 足 鳥 夂 ⺣ 止
作 : ｜ ノ ⺅ 一 乞
削 : ⺉ 月 ⺌
咋 : ｜ ノ 口
搾 : ｜ ノ 穴 儿 宀 心
昨 : ｜ ノ 日
朔 : 月 丷 屮
柵 : ｜ 一 木 亅 冂 冊 廾
窄 : ｜ ノ 穴 儿 宀
策 : ｜ 巾 竹 ハ 木 亅 冂 乞
索 : 糸 幺 小 十 冖
錯 : 金 日 廾 二
桜 : 女 ⺌ 木
鮭 : 魚 田 土 ⺣
笹 : 世 竹 乞
匙 : 日 匕 疋
冊 : ｜ 一 亅 冂 廾 冊
刷 : ⺉ 巾 尸
察 : ノ 示 二 小 宀 癶
拶 : 巛 夕 心
撮 : 耳 日 又 心
擦 : ノ 示 二 小 宀 心 癶
札 : 乙 木
殺 : 木 殳 ノ 丶 几 又
薩 : ノ 生 丷 立 亠 厂 ⺾ ⻖
雑 : 木 隹 九
皐 : 十 白 二
鯖 : 魚 月 青 田 土 二 亠 ⺣
捌 : ⺉ 口 力 心 勹
錆 : 金 月 青 土 二 亠
鮫 : 魚 田 父 亠 ⺣
皿 : 皿
晒 : 西 日
三 : 一 二
傘 : 十 人 ㅅ
参 : 一 厶 彡
山 : 山
惨 : 一 ⺖ 厶 彡
撒 : ｜ 月 夂 心 攵 廾 二 乞
散 : 月 攵 廾 二 乞
桟 : 木 戈 二
燦 : 火 米 又 夕
珊 : ｜ 一 王 亅 冂 冊 廾
産 : ノ 生 丷 立 亠 厂
算 : 竹 目 廾 乞
纂 : 糸 幺 小 竹 目 乞
蚕 : 一 大 虫 二
讃 : 貝 目 ハ 言 人 大 二 亠
賛 : 貝 目 ハ 人 大 二 亠
酸 : 酉 儿 厶 夂
餐 : 食 又 夕
斬 : 斤 車
暫 : 斤 車 日
残 : 歹 戈 二
仕 : ⺅ 士
仔 : ⺅ 子
伺 : ⺅ 口 亅 一
使 : ノ 一 ⺅ 口
刺 : ⺉ 巾 ハ 木 亅 冂
司 : 一 口 亅
史 : ノ 口
嗣 : ｜ 一 口 亅 冂
四 : 儿 囗
士 : 士
始 : 口 女 厶
姉 : 巾 女 亠
姿 : 欠 女 冫
子 : 子
屍 : 一 夕 匕 尸 歹
市 : 巾 亠
師 : ｜ 一 巾 口
志 : 士 心
思 : 心 田
指 : 日 匕 心
支 : 支 十 又
孜 : 子 攵 乞
斯 : 甘 斤 ハ
施 : ノ 方 一 也 乞
旨 : 日 匕
枝 : 支 木 十 又
止 : 止
死 : 一 夕 匕 歹
氏 : 氏
獅 : ｜ 巾 口 ⺨
祉 : 止 ⺭
私 : 禾 厶
糸 : 糸 幺 小
紙 : 氏 糸 幺 小
紫 : 止 糸 幺 小 匕
肢 : 月 支 十 又
脂 : 月 日 匕
至 : 一 至 土 厶
視 : 見 ⺭
詞 : 言 口 亅 一
詩 : 言 寸 土
試 : 言 工 弋
誌 : 言 士 心
諮 : 欠 言 口 冫
資 : 貝 目 ハ 欠 冫
賜 : 勿 貝 目 ハ 日 勿
雌 : 止 匕 隹
飼 : 口 艮 亅 ㅅ 食
歯 : 止 歯 米 凵
事 : 一 口 亅 ヨ
似 : ⺅ 人 丶
侍 : ⺅ 寸 土
児 : ｜ 日 儿
字 : 子 宀
寺 : 寸 土
慈 : 一 心 丷 幺
持 : 寸 土 心
時 : 寸 土 日
次 : 欠 冫
滋 : 一 ⺡ 丷 幺
治 : 口 ⺡ 厶
爾 : ｜ 一 ハ 冂 爻
璽 : ｜ 一 王 ハ 冂 爻
痔 : 寸 土 ⽧
磁 : 一 口 石 丷 幺
示 : 示 二 小
而 : 而
耳 : 耳
自 : 自 目
蒔 : 寸 土 日 ⺾
辞 : 口 十 辛 舌 立
汐 : ⺡ 夕
鹿 : 鹿 比 广
式 : 工 弋
識 : 音 言 日 立 戈
鴫 : 鳥 田 ⺣
竺 : 竹 二 乞
軸 : ｜ 車 日 田
宍 : ハ 亠 宀
雫 : 雨 丶 一 ｜
七 : 乙 匕 ノ
叱 : 口 匕
執 : ノ 九 十 辛 土 立 丶 亠
失 : ノ 人 二 大
嫉 : 女 矢 ⽧ 乞
室 : 至 土 厶 宀
悉 : ノ 心 釆 米
湿 : ｜ ⺡ 日
漆 : ⺡ 水 木 ㅅ
疾 : 矢 ⽧ 乞
質 : 貝 目 ハ 斤
実 : 士 大 宀
蔀 : 口 ⻏ 立 ⺾
篠 : ｜ ⺅ 竹 木 攵 乞
偲 : ⺅ 心 田
柴 : 止 木 匕
芝 : 亠 ⺾
屡 : 女 米 尸
蕊 : 心 ⺾
縞 : 口 高 糸 幺 小 亠 冂
舎 : 口 土 ㅅ
写 : 一 冖 勹
射 : 身 寸
捨 : 口 土 ㅅ 心
赦 : 赤 土 攵 乞
斜 : 禾 斗 ㅅ 一
煮 : 日 ⺹ ⺣
社 : 土 ⺭
紗 : ノ 糸 幺 小
者 : 日 ⺹
謝 : 言 身 寸
車 : 車
遮 : 一 ⻌ 广 ⺣
蛇 : 虫 匕 宀
邪 : 牙 ⻏
借 : ⺅ 日 廾 二
勺 : 丶 勹
尺 : 尸 丶
杓 : 木 丶 勹
灼 : 火 丶 勹
爵 : 艮 寸 爪 ⺲
酌 : 酉 丶 勹
釈 : 釆 米 尸 丶
錫 : 金 日 勿 勿
若 : ノ 一 口 ⺾
寂 : 小 卜 又 宀
弱 : 弓 冫
惹 : ノ 一 口 心 ⺾
主 : 王 丶
取 : 耳 又
守 : 寸 宀
手 : 手
朱 : ｜ ノ 牛 二 ハ 木
殊 : ｜ ノ 牛 二 ハ 木 歹
狩 : 寸 ⺨ 宀
珠 : ｜ ノ 王 牛 二 ハ 木
種 : ｜ 禾 日 里 ノ
腫 : ｜ 月 日 里 ノ
趣 : 耳 走 土 又
酒 : ⺡ 酉
首 : 自 首 丷 目
儒 : 雨 ⺅ 而
受 : 爪 又 冖
呪 : 口 儿
寿 : ノ 一 寸 二
授 : 爪 又 冖 心
樹 : 口 寸 土 豆 丷 木
綬 : 糸 幺 小 爪 又 冖
需 : 雨 而
囚 : 人 囗
収 : ｜ 又
周 : 口 土 冂
宗 : 示 二 小 宀
就 : 口 小 丶 亠 尤 尢
州 : ｜ 川 丶
修 : ｜ ⺅ 彡 攵 乞
愁 : 火 禾 心
拾 : 口 ㅅ 心 一
洲 : ｜ ⺡ 川 丶
秀 : 乃 禾 ノ
秋 : 火 禾
終 : 糸 幺 小 夂
繍 : ｜ ノ ヨ 糸 幺 小 水 隶
習 : 羽 白 冫
臭 : 自 大 目
舟 : 舟
蒐 : 鬼 田 儿 匕 ⺾ 厶
衆 : 血 皿 糸
襲 : 衣 月 立 亠
讐 : 言 隹
蹴 : ノ 乙 口 小 足 丶 亠 尤 尢 止
輯 : 口 耳 車
週 : 口 ⻌ 土 冂
酋 : 酉 丷
酬 : ｜ 川 酉 丶
集 : 木 隹
醜 : 鬼 田 酉 儿 匕 厶
什 : ⺅ 十
住 : 王 ⺅ 丶
充 : 亠 儿 厶
十 : 十
従 : 丷 疋 彳
戎 : 戈
柔 : 矛 木 マ
⺡ : 十 ⺡
渋 : 止 ⺡ 冫
獣 : 犬 口 ⺌ 田
縦 : 糸 幺 小 丷 疋 彳
重 : ｜ ノ 一 日 里
銃 : 金 亠 儿 厶
叔 : 小 卜 又
夙 : 几 歹
宿 : ⺅ 白 宀
淑 : ⺡ 小 卜 又
祝 : 口 ⺭ 儿
縮 : ⺅ 糸 幺 小 白 宀
粛 : ｜ ノ ヨ 米 隶
塾 : 丶 九 口 子 土 亠
熟 : 丶 九 口 子 亠 ⺣
出 : ｜ 山
術 : 行 十 丶 彳 木
述 : ⻌ 十 丶 木
俊 : ⺅ 儿 厶 夂
峻 : 山 儿 厶 夂
春 : 一 二 日 人 大
瞬 : 牛 舛 爪 目 夕 冖
竣 : 立 儿 厶 夂
舜 : 牛 舛 爪 夕 冖
駿 : 馬 儿 厶 夂 ⺣
准 : 冫 隹
循 : 斤 十 目 厂 彳
旬 : 日 勹
楯 : 斤 十 木 目 厂
殉 : 日 勹 歹
淳 : 口 子 ⺡ 亠
準 : 十 ⺡ 隹
潤 : 王 ⺡ 門
盾 : 斤 十 目 厂
純 : 糸 幺 小 屯
巡 : ⻌ 巛
遵 : ⻌ 寸 酉 丷
醇 : 口 子 酉 亠
順 : 貝 目 ハ 川 頁
処 : 几 夂 攵
⻂ : ⻂ 刀
所 : 斤 戸 一 尸
暑 : 日 ⺹
曙 : 日 ⺲ ⺹
渚 : ⺡ 日 ⺹
庶 : 广 ⺣
緒 : 糸 幺 小 日 ⺹
署 : 日 ⺲ ⺹
書 : 日 聿
薯 : 日 ⺲ ⺹ ⺾
藷 : 言 日 ⺹ ⺾
諸 : 言 日 ⺹
助 : 目 力
叙 : 禾 又 ㅅ 一
女 : 女
序 : 子 广 亅 マ 一
徐 : 禾 ㅅ 彳 一
恕 : 口 女 心
鋤 : 金 目 力
除 : 示 ㅅ ⻖ 一
傷 : ノ ⺅ 日 勿 一 人 勹 乞
償 : ⺅ 貝 目 ハ 口 ⺌ 冖
勝 : 月 人 大 二 丷 力
匠 : 斤 匚
升 : ノ 廾 十
召 : 口 刀
哨 : 月 口 ⺌
商 : 口 丷 立 亠 儿 冂
唱 : 口 日
嘗 : 口 ⺌ 日 冖 匕
奨 : 寸 大 爪 爿
妾 : 女 立
娼 : 女 日
宵 : 月 ⺌ 宀
将 : 寸 爪 爿
小 : 小
少 : ノ 小
⺌ : 口 ⺌ 冂
庄 : 土 广
床 : 木 广
廠 : 口 ⺌ 冂 广 攵 乞
彰 : 音 十 日 立 彡
承 : ノ 二 亅 手
抄 : ノ 小 心
招 : 口 刀 心
掌 : 口 手 ⺌ 冖
捷 : 疋 心 ヨ
昇 : ノ 日 廾 十
昌 : 日
昭 : 口 刀 日
晶 : 日
松 : ハ 木 厶
梢 : 月 ⺌ 木
樟 : 音 十 日 木 立
樵 : 木 ⺣ 隹
沼 : 口 ⺡ 刀
消 : 月 ⺡ ⺌
渉 : ノ 止 ⺡ 小
湘 : ⺡ 木 目
焼 : 火 十 儿
焦 : ⺣ 隹
照 : 口 刀 日 ⺣
症 : 一 止 ⽧
省 : ノ 小 目
硝 : 月 口 ⺌ 石
礁 : 口 石 ⺣ 隹
祥 : 王 丷 羊 ⺭
称 : ノ 禾 小 一 乞
章 : 音 十 日 立
笑 : 禾 竹 大 乞
粧 : 土 米 广
紹 : 口 糸 幺 小 刀
肖 : 月 ⺌
菖 : 日 ⺾
蒋 : 寸 爪 爿 ⺾
蕉 : ⺣ ⺾ 隹
衝 : ｜ 行 日 彳 里 ノ
裳 : 衣 口 ⺌ 冖 亠
訟 : 言 ハ 厶
証 : 一 言 止
詔 : 言 口 刀
詳 : 王 言 丷 羊
象 : 勹 豕 口 一
賞 : 貝 目 ハ 口 ⺌ 冖
醤 : 寸 爪 酉 爿
鉦 : 一 金 止
鍾 : ｜ 金 日 里 ノ
鐘 : 金 里 立
障 : 音 十 日 立 ⻖
鞘 : 革 月 ⺌
上 : 一 卜
丈 : ノ 一 丶
丞 : ノ 一 亅
乗 : ｜ ノ 一 禾 ハ
冗 : 冖 几
剰 : ｜ ノ 一 ⺉
城 : ノ 土 戈
場 : 土 日 勿 一 勿
壌 : 衣 土 ハ 亠
嬢 : 衣 女 ハ 亠
常 : 巾 口 ⺌ 冖
情 : 月 青 土 二 ⺖ 亠
擾 : 一 心 白 冖 夂 心 自
条 : 木 夂 攵
杖 : ノ 一 木
浄 : ⺡ 亅 勹 ヨ
状 : 犬 爿
畳 : 一 田 冖
穣 : 衣 禾 ハ 亠
蒸 : ノ 一 亅 ⺣ ⺾
譲 : 衣 言 ハ 亠
醸 : 衣 酉 ハ 亠
錠 : 金 疋 宀
嘱 : 口 尸 ⽱
埴 : 十 土 目
飾 : ノ 巾 食 一 人 乞
拭 : 工 弋 心
植 : 十 木 目
殖 : 十 目 歹
燭 : 火 虫 ⺲ 勹
織 : 音 糸 幺 小 日 立 戈
職 : 音 耳 日 立 戈
色 : 色 巴 勹
触 : 角 虫
食 : 食
蝕 : 食 虫
辱 : 衣 寸 辰 厂
尻 : 九 尸
伸 : ｜ ⺅ 日 田
信 : ⺅ 言
侵 : ヨ ⺅ 又 冖
唇 : 衣 口 辰 厂
娠 : 衣 女 辰 厂
寝 : ヨ 又 冖 宀 爿
審 : 田 釆 米 宀
心 : 心
慎 : 一 十 ハ ⺖ 目
振 : 衣 辰 厂 心
新 : 斤 辛 丷 木 立 亠
晋 : 一 日
森 : 木
榛 : 一 禾 人 二 木
浸 : ヨ ⺡ 又 冖
深 : ⺡ 木 儿 冖
申 : ｜ 日 田
疹 : ㅅ 彡 ⽧
真 : 一 十 ハ 目
神 : ｜ 日 ⺭ 田
秦 : 一 禾 二 人 大
紳 : ｜ 糸 幺 小 日 田
臣 : 臣 匚
芯 : 心 ⺾
薪 : 斤 辛 丷 木 立 ⺾ 亠
親 : 見 辛 丷 木 立 亠
診 : 言 ㅅ 彡
身 : 身
辛 : 十 辛 立
進 : ⻌ 隹
針 : 金 十
震 : 衣 雨 辰 厂
人 : 人
仁 : ⺅ 二
刃 : 刀 丶
塵 : 鹿 土 比 广
壬 : ノ 士
尋 : ヨ 口 工 寸
甚 : 一 甘 儿
尽 : 尸 丶
腎 : 月 臣 又
訊 : ノ 言 几
迅 : ⻌ 十 乙
陣 : 車 ⻖
靭 : 革 刀 丶
笥 : 一 口 竹 亅 乞
諏 : 言 耳 又
須 : 貝 目 ハ 頁 彡
酢 : ｜ ノ 酉
図 : 斗 囗
厨 : 口 寸 豆 丷 厂
逗 : 口 ⻌ 豆 丷
吹 : 欠 口
垂 : ｜ ノ 一
帥 : ｜ 巾 口
推 : 心 隹
水 : 水
炊 : 火 欠
睡 : ｜ ノ 一 目
粋 : 九 十 米
翠 : 羽 十 人 亠 冫
衰 : 衣 一 亠
遂 : ⻌ 丷 豕
酔 : 九 十 酉
錐 : 金 隹
錘 : ｜ ノ 一 金
随 : ノ 一 月 ⻌ ⻖
瑞 : 王 山 而
髄 : ノ 一 月 ⻌ 冖 骨
崇 : 山 示 二 小 宀
嵩 : 口 高 山 亠 冂
数 : 女 米 攵 夂 乞
枢 : 木 匚
趨 : 走 土 勹 屮
雛 : 勹 屮 隹
据 : 口 十 尸 心
杉 : 木 彡
椙 : 日 木
菅 : ｜ 口 宀 ⺾
頗 : 貝 目 ハ 皮 頁 又
雀 : ノ 小 隹
裾 : 口 十 ⻂ 尸
澄 : 口 ⺡ 豆 丷 癶
摺 : 羽 白 冫 心
寸 : 寸
世 : ｜ 一 世
瀬 : ｜ 貝 目 ハ ⺡ 頁 木 口
畝 : 田 亠 久
是 : 日 疋
凄 : 女 冫 ヨ 十
制 : ノ ⺉ 牛 巾 二
勢 : 土 力 丶 儿 九
姓 : 女 生
征 : 一 止 彳
性 : 生 ⺖
成 : ノ 戈
政 : 一 止 攵 乞
整 : ｜ 一 口 止 木 攵 乞
星 : 生 日
晴 : 月 青 土 二 日 亠
棲 : 女 木 ヨ 十
栖 : 西 木
正 : 一 止
清 : 月 ⺡ 青 土 二 亠
牲 : 牛 生
生 : 生
盛 : ノ 皿 戈
精 : 月 青 土 二 米 亠
聖 : 王 口 耳
声 : 士 尸
製 : 衣 ⺉ 牛 巾 亠
西 : 西
誠 : ノ 言 戈
誓 : 斤 言 心
請 : 月 言 青 土 二 亠
逝 : 斤 ⻌ 心
醒 : 生 酉 日
青 : 月 青 土 二 亠
静 : 月 青 土 亅 亠 勹 ヨ 二
斉 : ｜ ノ 文 廾 斉
税 : 禾 口 丷 儿
脆 : 月 厂 勹 卩
隻 : 又 隹
席 : 巾 广 一 凵
惜 : ｜ 一 二 日 ⺖
戚 : ノ 小 卜 戈
斥 : 斤 丶
昔 : ｜ 一 二 日
析 : 斤 木
石 : 口 石
積 : 禾 貝 目 ハ 土 亠 二
籍 : ｜ 一 竹 土 日 ハ 木 亠 耒 二 ノ 乞
績 : 貝 目 ハ 糸 幺 小 土 亠 二
脊 : 月 二 人
責 : 貝 目 ハ 土 亠 二
赤 : 赤 土
跡 : 口 止 赤 足 亠
蹟 : 貝 目 ハ 口 足 土 亠 止 二
碩 : 貝 目 ハ 口 石 頁
切 : 刀 匕
拙 : ｜ 山 心
接 : 女 立 心
摂 : 耳 冫 心
折 : 斤 心
設 : 言 殳 几 又
窃 : 穴 刀 儿 匕 宀
節 : 艮 竹 卩 乞
説 : 言 口 丷 儿
雪 : ヨ 雨
絶 : 糸 幺 小 色
舌 : 口 舌
蝉 : 十 ⺌ 虫 田
仙 : ⺅ 山
先 : ノ 土 儿
千 : ノ 十
占 : 口 卜
宣 : 一 日 宀
専 : 十 寸 田
尖 : 小 大
川 : 川
戦 : 十 ⺌ 田 戈
扇 : 羽 戸 冫 一 尸
撰 : ｜ 二 ハ 已 心
栓 : 王 木 ㅅ
栴 : ノ 木 冂 乞
泉 : 水 白
浅 : ⺡ 戈 二
洗 : ノ ⺡ 土 儿
染 : 九 ⺡ 木
潜 : ⺡ 日 二 大
煎 : 一 ⺉ 月 丷 ⺣
煽 : 羽 火 戸 冫 一 尸
旋 : 疋 方 乞
穿 : 牙 穴 儿 宀
箭 : 一 ⺉ 月 竹 丷 乞
線 : 糸 幺 小 水 白
繊 : 糸 幺 小 土 戈 赤
羨 : 王 欠 ⺡ 丷 羊
腺 : 月 水 白
舛 : 舛 夕
船 : 口 舟 ハ
薦 : 广 ⺣ ⺾
詮 : 王 言 ㅅ ハ
賎 : 貝 目 ハ 戈 二
践 : 口 足 戈 二 止
選 : ｜ ⻌ 二 ハ 已
遷 : ⻌ 西 大 已
銭 : 金 戈 二
銑 : ノ 金 土 儿
閃 : 人 門
鮮 : 王 魚 田 丷 羊 ⺣
前 : 一 ⺉ 月 丷
善 : 王 口 丷 羊
漸 : 斤 車 ⺡
然 : 犬 夕 ⺣
全 : 王 ハ ㅅ
禅 : 十 ⺌ 田 ⺭
繕 : 王 口 糸 幺 小 丷 羊
膳 : 王 月 口 丷 羊
糎 : 米 里 厂
噌 : 口 田 日 丷
塑 : 月 土 丷 屮
岨 : 一 山 目
措 : ｜ 一 二 日 心
曾 : 日 ハ
曽 : 田 日 丷
楚 : 疋 木
狙 : 一 ⺨ 目
疏 : 止 川 亠 厶
疎 : ｜ 一 口 止 木
礎 : 口 石 疋 木
祖 : 一 目 ⺭
租 : 一 禾 目
粗 : 一 米 目
素 : 糸 幺 小 土 亠 二
組 : 一 糸 幺 小 目
蘇 : 禾 魚 田 ⺣ ⺾
訴 : 斤 言 丶
阻 : 一 目 ⻖
遡 : 月 ⻌ 丷 屮
鼠 : 臼 鼠
僧 : ⺅ 田 日 丷
創 : ⺉ 口 ㅅ 一
双 : 又 丶
叢 : 王 耳 丷 又 羊
倉 : ノ 口 ㅅ 尸 一
喪 : ｜ 衣 一 口 亠
壮 : 士 爿
奏 : 一 禾 大 二 人
爽 : 一 人 亠
宋 : 木 宀
層 : 田 日 丷 尸
匝 : 巾 匚
惣 : 牛 心 勿 勿
想 : 心 木 目
捜 : ｜ 日 又 心 田
掃 : ヨ 巾 冖 心
挿 : ｜ ノ 十 日 心 田
掻 : 虫 又 心
操 : 口 木 心 品
早 : 十 日
曹 : ｜ 一 日
巣 : ⺌ 田 木
槍 : 口 木 ㅅ 一
槽 : ｜ 一 日 木
漕 : ｜ 一 ⺡ 日
燥 : 火 口 木 品
争 : ヨ 一 亅 勹
痩 : 又 ⽧
相 : 木 目
窓 : 穴 心 儿 厶 宀
糟 : ｜ 一 日 米
総 : 糸 幺 小 心 ハ 厶
綜 : 糸 幺 小 示 二 宀
聡 : 耳 心 ハ 厶
草 : 十 日 ⺾
荘 : 士 爿 ⺾
葬 : 一 夕 匕 廾 ⺾
蒼 : ノ 口 ㅅ ⺾ 一
藻 : 口 ⺡ 木 ⺾ 品
装 : 衣 士 爿 亠
走 : 走 土
送 : ⻌ 丷 大 一 二
遭 : ｜ 一 ⻌ 日
鎗 : ノ 金 口 ㅅ 一
霜 : 雨 木 目
騒 : 虫 馬 又 ⺣
像 : ⺅ 勹 豕 口 一
増 : 田 土 日 丷
憎 : 田 日 丷 ⺖
臓 : ノ 月 臣 戈 ⺾ 厂
蔵 : ノ 臣 戈 ⺾ 厂
贈 : 貝 目 ハ 田 日 丷
造 : ノ 口 ⻌ 土
促 : ⺅ 口 足 止
側 : ⺅ 貝 目 ハ ⺉
則 : 貝 目 ハ ⺉
即 : 艮 卩
息 : 自 心 目
捉 : 口 足 心 止
束 : ｜ 一 口 ハ 木
測 : 貝 目 ハ ⺉ ⺡
足 : 口 足 止
速 : ｜ 一 口 ⻌ ハ 木
俗 : ⺅ 口 谷 ハ ㅅ
属 : ノ 尸 ⽱
賊 : 貝 目 ハ 十 戈
族 : 方 矢 乞
続 : 士 糸 幺 小 儿 冖
卒 : 十 人 亠
袖 : ｜ 一 ⻂ 田
其 : 一 甘 ハ
揃 : 一 ⺉ 月 丷 心
存 : ｜ ノ 一 子
孫 : ノ 子 糸 幺 小
尊 : 寸 酉 丷
損 : 貝 目 ハ 口 心
村 : 寸 木
遜 : ノ ⻌ 子 糸 幺 小
他 : ⺅ 也
多 : 夕
太 : 大 丶
汰 : ⺡ 大 丶
詑 : 言 匕 宀
唾 : ｜ ノ 一 口
堕 : ノ 一 月 土 ⻖
妥 : 女 爪
惰 : ノ 一 月 工 ⺖
打 : 亅 心
柁 : 木 匕 宀
舵 : 舟 匕 宀
楕 : ノ 一 月 工 木
陀 : 匕 宀 ⻖
駄 : 大 馬 丶 ⺣
騨 : 十 ⺌ 田 馬 ⺣
体 : 木 一 ⺅
堆 : 土 隹
対 : 寸 文
耐 : 而 寸
岱 : ⺅ 山 弋
帯 : ｜ 一 巾 冖
待 : 寸 土 彳
怠 : 口 心 厶
態 : 月 心 匕 厶
戴 : ｜ 一 田 土 二 ハ 戈
替 : 人 大 二 日 亠
泰 : ｜ 一 水 二 人 大
滞 : 巾 ⺡ 冖
胎 : 月 口 厶
腿 : 月 ⻌ 艮
苔 : 口 厶 ⺾
袋 : 衣 ⺅ 弋 亠
貸 : ⺅ 貝 目 ハ 弋
退 : ⻌ 艮
逮 : ヨ ⻌ 水 隶
隊 : 丷 豕 ⻖
黛 : ⺅ 黒 里 弋 ⺣
鯛 : 魚 口 田 土 冂 ⺣
代 : ⺅ 弋
台 : 口 厶
大 : 大
第 : 弓 竹 乞
醍 : 酉 日 疋
題 : 貝 目 ハ 日 疋 頁
鷹 : ⺅ 鳥 广 ⺣ 隹
滝 : ⺡ 田 立 竜
瀧 : 月 ⺡ 立
卓 : 十 日 卜
啄 : 口 豕
宅 : ノ 一 乙 宀
托 : ノ 一 乙 心
択 : 尸 心 丶
拓 : 口 石 心
沢 : ⺡ 尸 丶
濯 : ヨ ⺡ 隹
琢 : 王 豕
託 : ノ 一 乙 言
鐸 : 金 十 辛 ⺲ 立 亠
濁 : ⺡ 虫 ⺲ 勹
諾 : ノ 一 言 口 ⺾
茸 : 耳 ⺾
凧 : ｜ 巾 冂 几
蛸 : 月 ⺌ 虫
只 : 口 ハ
叩 : 口 卩
但 : 一 ⺅ 日
達 : 王 ⻌ 土 丷 羊
辰 : 衣 辰 厂
奪 : 寸 大 隹
脱 : 月 口 丷 儿
巽 : ｜ 一 二 ハ 已
竪 : 臣 又 立
辿 : ⻌ 山
棚 : 月 木
谷 : 口 谷 ハ ㅅ
狸 : ⺨ 里
鱈 : ヨ 雨 魚 田 ⺣
樽 : 寸 酉 丷 木
誰 : 言 隹
丹 : ノ 一 丶 亅
単 : 十 ⺌ 田
嘆 : ノ 一 口 ⺾ 二 大
坦 : 一 土 日
担 : 一 日 心
探 : 木 儿 冖 心
旦 : 一 日
歎 : 大 一 欠 ⺾ 口 二
淡 : 火 ⺡
湛 : ｜ 一 甘 ⺡ 儿 匚
炭 : 火 山 厂
短 : 口 豆 丷 矢 乞
端 : 山 而 立
箪 : 十 ⺌ 竹 田 乞
綻 : 糸 幺 小 疋 宀
耽 : 耳 尢 冖
胆 : 一 月 日
蛋 : 虫 疋
誕 : ノ 言 止 廴
鍛 : 金 殳 几 又
団 : 寸 囗
壇 : 一 口 土 日 亠 囗
弾 : 弓 十 ⺌ 田
断 : 斤 米 ｜ 一
暖 : ノ 一 爪 日 又
檀 : 一 口 日 木 亠
段 : ｜ 殳 几 又 ノ 一
男 : 田 力
談 : 火 言
値 : ⺅ 十 目 ｜ 一
知 : 口 矢 乞
地 : 土 也
弛 : 弓 也
恥 : 耳 心
智 : 口 日 矢 乞
池 : ⺡ 也
痴 : 口 矢 ⽧ 乞
稚 : 禾 隹
置 : 十 ⺲ 目 一 ｜
致 : 至 土 厶 攵 乞
蜘 : 口 虫 矢 乞
遅 : 王 ⻌ 丷 羊 尸
馳 : 馬 也 ⺣
築 : 工 竹 木 丶 几
畜 : 玄 田 亠 幺
竹 : 竹 乞
筑 : 工 竹 丶 几 乞
蓄 : 玄 田 亠 幺 ⺾
逐 : ⻌ 豕
秩 : ノ 禾 人 土 大
窒 : 一 穴 至 土 儿 厶 宀
茶 : ㅅ ⺾ 木
嫡 : 口 十 女 丷 立 亠 冂 啇
着 : ノ 王 丷 目 羊
中 : ｜ 口
仲 : ｜ ⺅ 口
宙 : ｜ 日 宀 田
忠 : ｜ 口 心
抽 : ｜ 日 心 田
昼 : 一 日 尸 丶
柱 : 王 木 丶
注 : 王 ⺡ 丶
虫 : 虫
衷 : 衣 十 口
註 : 王 言 丶
酎 : 寸 酉
鋳 : ノ 亠 土 金 寸
駐 : 王 馬 丶 ⺣
樗 : 雨 木 二 勹
瀦 : ⺡ 日 ⺹ 豕
猪 : 日 ⺨ ⺹
苧 : 一 亅 宀 ⺾
著 : 日 ⺹ ⺾
貯 : 一 貝 目 ハ 亅 宀
丁 : 一 亅
兆 : 儿 冫
凋 : 口 土 冂 冫
喋 : 口 木 世
寵 : 月 立 宀
帖 : 巾 口 卜
帳 : 巾 長
庁 : 一 亅 广
弔 : ｜ 弓
張 : 弓 長
彫 : 口 土 冂 彡
徴 : 王 山 彳 攵 乞
懲 : 王 山 心 彳 攵 乞
挑 : 儿 冫 心
暢 : ｜ 一 日 勿 田 勿
朝 : 月 十 日
潮 : 月 十 ⺡ 日
牒 : 片 木 世
町 : 一 田 亅
眺 : 目 儿 冫
聴 : 耳 十 心 ⺲
脹 : 月 長
腸 : 一 月 日 勿 勿
蝶 : 虫 木 世
調 : 言 口 土 冂
諜 : 言 木 世
超 : 口 走 土 刀
跳 : 口 足 儿 冫 止
銚 : 金 儿 冫
長 : 長
頂 : 一 貝 目 ハ 頁 亅
鳥 : 鳥 ⺣
勅 : ｜ 一 口 木 力
捗 : ノ 止 小 心
直 : 十 目 ｜ 一
朕 : 月 人 大 一 丷
沈 : ⺡ 尢 冖
珍 : 王 ㅅ 彡
賃 : 王 ⺅ 貝 目 ハ
鎮 : 金 十 丷 目 一 ハ
陳 : ｜ 一 田 日 木 ⻖
津 : ⺡ 聿
墜 : 土 丷 豕 ⻖
椎 : 木 隹
槌 : ｜ 口 ⻌ 木
追 : ｜ 口 ⻌
鎚 : ｜ 金 口 ⻌
痛 : 用 ⽧ マ
通 : ⻌ 用 マ
塚 : 土 冖 豕
栂 : 母 木 毋
掴 : 王 囗 心 丶
槻 : 見 人 大 木 一 二
佃 : ⺅ 田
漬 : 貝 目 ハ ⺡ 土 亠 二
柘 : 口 石 木
辻 : ⻌ 十
蔦 : 鳥 ⺣ ⺾
綴 : 糸 幺 小 又
鍔 : 金 口 二 勹
椿 : 一 二 日 木 人 大
潰 : 貝 目 ハ ⺡ 十 口 ｜ 一
坪 : 干 土 丷
壷 : ｜ 一 口 士 冖
嬬 : 雨 而 女
紬 : ｜ 糸 幺 小 日 田
爪 : 爪
吊 : 巾 口
釣 : 金 丶 勹
鶴 : 鳥 ⺣ 隹 宀 冖
亭 : 口 亅 亠 冖
低 : ⺅ 氏 一
停 : ⺅ 口 亅 亠 冖 一
偵 : ⺅ 貝 目 ハ 卜
剃 : ｜ ノ ⺉ 弓 丷
貞 : 貝 目 ハ 卜
呈 : 王 口
堤 : 土 日 疋
定 : 疋 宀
帝 : 巾 丷 立 亠 冖
底 : 氏 广
庭 : 王 广 廴
廷 : 王 廴 士
弟 : ｜ ノ 弓 丷
悌 : ｜ ノ 弓 丷 ⺖
抵 : 氏 心
挺 : 王 廴 心
提 : 日 疋 心
梯 : ｜ ノ 弓 丷 木
汀 : 一 ⺡ 亅
碇 : 口 石 疋 宀
禎 : 貝 目 ハ 卜 ⺭
程 : 王 禾 口
締 : 巾 糸 幺 小 丷 立 亠 冖
艇 : 王 舟 廴
訂 : 一 言 亅
諦 : 巾 言 丷 立 亠 冖
蹄 : 巾 口 足 丷 立 亠 冖 止
逓 : 巾 ⻌ 厂 二 ｜
邸 : 氏 ⻏
鄭 : 大 酉 丷 ⻏
釘 : 一 金 亅
鼎 : ｜ 一 鼎 片 目 爿
泥 : ⺡ 匕 尸
摘 : 口 十 丷 立 亠 冂 心 啇
擢 : ヨ 心 隹
敵 : 口 十 丷 立 亠 冂 攵 啇 乞
啇 : 口 十 ⺡ 丷 立 亠 冂 啇
的 : 白 丶 勹
笛 : ｜ 竹 日 田 乞
適 : 口 ⻌ 十 丷 立 亠 冂 啇
鏑 : 金 口 十 丷 立 亠 冂 啇
溺 : 弓 ⺡ 冫
哲 : 斤 口 心
徹 : 月 亠 厶 彳 攵 乞
撤 : 月 亠 厶 心 攵 乞
轍 : 月 車 亠 厶 攵 乞
迭 : ｜ ノ 一 牛 ⻌ 矢 大 二 乞
鉄 : ノ 金 二 矢 大 乞
典 : ｜ 一 日 ハ
填 : 十 土 ハ 目
天 : 一 大 二
展 : ｜ 衣 一 二 尸
店 : 口 卜 广
添 : ノ ⺡ 心 大 一 二
纏 : 糸 幺 小 土 里 儿 广
甜 : 甘 口 舌
貼 : 貝 目 ハ 口 卜
転 : 車 二 厶
顛 : 貝 十 ハ 頁 目
点 : 口 卜 ⺣
伝 : ⺅ 二 厶
殿 : ｜ 一 二 ハ 尸 殳 几 又
澱 : ｜ 一 ⺡ 二 ハ 尸 殳 几 又
田 : 田
電 : 雨 田 乙
兎 : ノ 丶 儿 口 ｜
吐 : 口 土
堵 : 土 日 ⺹
塗 : ⺡ 土 ハ ㅅ 亅 木 一
妬 : 口 女 石
屠 : 日 ⺹ 尸
徒 : 走 土 彳
斗 : 斗
杜 : 土 木
渡 : ⺡ 又 广
登 : 口 豆 丷 癶
菟 : 丶 儿 ⺾ 勹 口 ｜
賭 : 貝 目 ハ 日 ⺹
途 : ⻌ ハ ㅅ 亅 木 一
都 : 日 ⻏ ⺹
鍍 : 金 又 广
砥 : 口 氏 石
砺 : 一 斤 口 石 厂
努 : 女 又 力
度 : 又 广 一 凵
土 : 土
奴 : 女 又
怒 : 女 心 又
倒 : ⺅ ⺉ 至 土 厶
党 : 口 ⺌ 儿 冖
冬 : 夂 丶 攵
凍 : ｜ 一 日 木 冫 田
刀 : 刀
唐 : ｜ ヨ 一 口 广
塔 : 口 土 ㅅ ⺾ 一
塘 : ｜ ヨ 一 口 土 广
套 : 大 長 厶
宕 : 口 石 宀
島 : 山 鳥 白
嶋 : 山 鳥 ⺣
悼 : 十 日 ⺖ 卜
投 : 心 殳 几 又
搭 : 口 ㅅ 心 ⺾ 一
東 : ｜ 一 日 木 田
桃 : 木 儿 冫
梼 : ノ 寸 木 土 亠 二
棟 : ｜ 一 日 木 田
盗 : 欠 皿 冫
淘 : 缶 ⺡ 凵 勹
湯 : ｜ 一 ⺡ 日 勿 勿
涛 : ノ ⺡ 寸 土 亠 二
灯 : 一 火 亅
燈 : 口 豆 丷 癶 火
当 : ヨ ⺌
痘 : 口 豆 丷 ⽧
祷 : ノ 寸 ⺭ 土 亠 二
等 : 寸 竹 土 乞
答 : 口 竹 ㅅ 一 乞
筒 : 口 竹 冂 乞 一
糖 : 口 米 广
統 : 糸 幺 小 亠 儿 厶
到 : ⺉ 至 土 厶
董 : ｜ 一 日 ⺾ 里 ノ
蕩 : ｜ 一 ⺡ 日 ⺾ 勿 勿
藤 : ｜ 一 月 水 ⺾ 二 大
討 : 言 寸
謄 : ｜ 一 月 言 二 大
豆 : 口 豆 丷
踏 : 口 水 足 日 止
逃 : ⻌ 儿 冫
透 : ノ 禾 ⻌ 乃
鐙 : 金 口 豆 丷 癶
陶 : 缶 勹 ⻖
頭 : 貝 目 ハ 口 豆 丷 頁
騰 : 月 馬 丷 一 人 大 二 ⺣
闘 : 口 寸 豆 丷 門
働 : ｜ 一 ⺅ 力 日 ノ
動 : ｜ 一 日 力 里 ノ
同 : 口 冂 一
堂 : 口 ⺌ 土 冖
導 : ⻌ 自 寸 丷 首
憧 : ⺖ 里 立
撞 : 里 立 心
洞 : 口 ⺡ 冂 一
瞳 : 目 里 立
童 : 里 立
胴 : 月 口 冂 一
萄 : 缶 勹 ⺾
道 : ⻌ 自 丷 首
銅 : 金 口 冂 一
峠 : ｜ 一 山 卜
鴇 : 十 鳥 匕 ⺣
匿 : ノ 口 匚 ⺾
得 : 寸 日 彳 一
徳 : 十 心 ⺲ 彳
涜 : 士 ⺡ 儿 冖
特 : 牛 寸 土
督 : 小 卜 又 目
禿 : 禾 儿
篤 : 竹 ⺣ 馬 乞
毒 : 土 母 亠 毋 二
独 : 虫 ⺨
読 : 言 士 儿 冖
栃 : 斤 木 厂
橡 : 木 豕 勹 口 ｜
凸 : ｜ 一 冂 凵
突 : 穴 大 儿 宀
椴 : 木 殳 几 又
届 : ｜ 日 尸 田
鳶 : 鳥 弋 ⺣
苫 : 口 卜 ⺾
寅 : 田 ハ 宀 一
酉 : 酉
瀞 : 月 ⺡ 青 土 亅 亠 ヨ 二
噸 : 貝 目 ハ 口 頁 屯
屯 : ノ 乙 凵 屯
惇 : 口 子 ⺖ 亠
敦 : 口 子 亠 攵 乞
沌 : ⺡ 屯
豚 : 月 豕
遁 : 斤 ⻌ 十 目 厂
頓 : 貝 目 ハ 頁 屯
呑 : ノ 口 大
曇 : 雨 二 日 厶
鈍 : 金 屯
奈 : 示 二 小 大
那 : 刀 ⻏ 二
内 : 人 冂
乍 : ｜ ノ 一 乞
凪 : 止 几
薙 : 矢 ⺾ 隹 乞
謎 : 言 ⻌ 米
灘 : ⺡ 大 口 ⺾ 隹 亠 二
捺 : 示 二 小 大 心
鍋 : 金 口 冂
楢 : 酉 丷 木
馴 : 川 ⺣ 馬 ⺣
縄 : 亀 糸 幺 小 田 乙 勹
畷 : 田 又
南 : 干 十 丷 冂
楠 : 干 十 丷 木 冂
軟 : 欠 車
難 : ⺾ 隹 大 口 亠 二
汝 : ⺡ 女
二 : 二
尼 : 匕 尸
弐 : 一 弋 二
迩 : ノ ⻌ 小 乞
匂 : 勹 匕
賑 : 貝 目 ハ 辰 衣
肉 : 肉 冂 人
虹 : 工 虫
廿 : ｜ 一 凵
日 : 日
乳 : 乙 子 爪
入 : 入
如 : 口 女
尿 : 水 尸
韮 : 韭 ⺾
任 : ノ 王 ⺅ 士
妊 : ノ 王 士 女
忍 : 心 刀 丶
認 : 言 心 刀 丶
濡 : 雨 而 ⺡
禰 : ｜ 一 ⺭ 冂 爻
祢 : ノ 小 ⺭
寧 : 一 心 ⺲ 亅 宀 皿
葱 : 勿 心 丶 ⺾ 勿
猫 : 田 ⺨ ⺾
熱 : 土 九 丶 儿 ⺣
年 : ノ 一 干 乞
念 : ｜ 一 心 ㅅ
捻 : ｜ 一 心 ㅅ 心
撚 : 犬 夕 心 ⺣
燃 : 火 犬 夕 ⺣
粘 : 口 米 卜
乃 : ｜ ノ 一 乃
廼 : 西 廴
之 : 乙 丶 亠 廴
埜 : 土 木
嚢 : ｜ 衣 一 口 ハ 亠 冖
悩 : ⺌ ⺖ 凵
濃 : ｜ 衣 一 ⺡ 辰 日 厂
納 : 糸 幺 小 人 冂
能 : 月 匕 厶
脳 : 月 ⺌ 凵
膿 : ｜ 衣 一 月 辰 日 厂
農 : ｜ 衣 一 辰 日 厂
覗 : 見 口 亅 一
蚤 : 虫 又
巴 : 乙 已 巴
把 : 巴 心
播 : 田 釆 米 心
覇 : 革 月 西
杷 : 木 巴
波 : ⺡ 皮 又
派 : 斤 ⺡ 厂
琶 : 王 巴
破 : 口 石 皮 又
婆 : ⺡ 女 皮 又
罵 : 馬 ⺲ ⺣
芭 : 巴 ⺾
馬 : 馬 ⺣
俳 : ⺅ 非
廃 : 一 儿 广 癶
拝 : ｜ 一 干 心
排 : 非 心
敗 : 貝 目 ハ 攵 乞
杯 : ｜ ノ 一 木 ⺭
盃 : ノ 一 皿
牌 : 十 田 片
背 : 月 匕 爿
肺 : 巾 月 亠
輩 : 車 非
配 : 酉 已
倍 : ⺅ 口 立
培 : 口 土 立
媒 : 甘 女 木
梅 : 母 木 毋 乞
楳 : 甘 木
煤 : 火 甘 木
狽 : 貝 目 ハ ⺨
⺲ : 貝 目 ハ ⺲
売 : 士 儿 冖
賠 : 貝 目 ハ 口 立
陪 : 口 立 ⻖
這 : 言 ⻌
蝿 : 亀 虫 田 乙 勹
秤 : 禾 干 丷
矧 : ｜ 弓 矢 乞
萩 : 火 禾 ⺾
伯 : ⺅ 白
剥 : ヨ ⺉ 水
博 : 十 寸 田 丶
拍 : 白 心
柏 : 白 木
泊 : ⺡ 白
白 : 白
箔 : ⺡ 竹 白 乞
粕 : 白 米
舶 : 舟 白
薄 : 十 ⺡ 寸 田 丶 ⺾
迫 : ⻌ 白
曝 : ｜ 一 水 日 ハ
漠 : ⺡ 大 日 ⺾
爆 : ｜ 一 火 水 日 ハ 井
縛 : 糸 幺 小 十 寸 田 丶
莫 : 大 日 ⺾
駁 : 馬 爻 ⺣
麦 : 麦 夂 土 二 亠
函 : 一 水 凵
箱 : 竹 木 目 乞
硲 : 口 石 谷 ハ ㅅ
箸 : 竹 日 ⺹ 乞
肇 : 戸 攵 聿 一 尸 乞
筈 : 口 舌 竹 乞
櫨 : 皿 田 卜 木 匕 厂 虍
幡 : 巾 田 釆 米
肌 : 月 几
畑 : 火 田
畠 : 田 白
八 : ハ
鉢 : 一 金 木
溌 : 二 ⺡ 儿 癶
発 : 二 儿 癶
醗 : 二 酉 儿 癶
髪 : 夂 一 長 彡 髟
伐 : ⺅ 戈
罰 : ⺉ 言 ⺲
抜 : 夂 亠 心 又
筏 : ⺅ 竹 戈 乞
閥 : ⺅ 門 戈
鳩 : 九 鳥 ⺣
噺 : 斤 口 辛 丷 木 立 亠
塙 : 口 高 土 亠 冂
蛤 : 口 虫 ㅅ 一
隼 : 十 隹
伴 : ｜ ⺅ 二 丷 十
判 : ｜ ⺉ 二 丷 十
半 : ｜ 二 丷 十
反 : 又 厂
叛 : 丷 又 厂
帆 : 巾 丶 几
搬 : 舟 心 殳 几 又
斑 : 王 文
板 : 又 木 厂
氾 : 乙 ⺡ 卩
汎 : ⺡ 丶 几
版 : 片 又 厂
⺨ : 乙 ⺨ 卩
班 : 王 ⺉
畔 : ｜ 田 二 丷 十
繁 : 糸 幺 小 母 攵 毋 乞
般 : 舟 殳 几 又
藩 : ⺡ 田 釆 米 ⺾
販 : 貝 目 ハ 又 厂
範 : 乙 車 竹 卩 乞
釆 : 釆 米
煩 : 火 貝 目 ハ 頁
頒 : 貝 目 刀 ハ 頁
飯 : 食 又 厂
挽 : ｜ 一 免 儿 心 勹
晩 : 免 日 儿 勹
番 : 田 釆 米
盤 : 皿 舟 殳 几 又
磐 : 口 舟 石 殳 几 又
蕃 : 田 釆 米 ⺾
蛮 : 虫 亠
匪 : 非 匚
卑 : 十 田
否 : ノ 一 口 ｜ 丶
妃 : 女 已
庇 : 比 广
彼 : 皮 又 彳
悲 : 心 非
扉 : 戸 非 一 尸
批 : 比 心
披 : 皮 又 心
斐 : 非 文
比 : 比
泌 : ノ ⺡ 心 丶
疲 : 皮 又 ⽧
皮 : 皮 又
碑 : 口 十 石 田
秘 : ノ 禾 心 丶
緋 : 糸 幺 小 非
罷 : 月 ⺲ 匕 厶
肥 : 月 巴
被 : ⻂ 皮 又
誹 : 言 非
費 : ｜ 貝 目 ハ 弓
避 : 口 ⻌ 十 辛 立 尸
非 : 非
飛 : 飛
樋 : ⻌ 木 用 マ
簸 : 甘 竹 皮 又 乞
備 : ⺅ 用 厂 ⺾
尾 : 毛 尸
微 : 山 彳 攵 乞
枇 : 比 木
毘 : 田 比
琵 : 王 比
眉 : 目 尸 ｜
美 : 王 大 丷 羊
鼻 : 自 田 廾 鼻 目
柊 : 木 夂 丶
稗 : 禾 十 田
匹 : 儿 匚
疋 : 疋
髭 : 止 長 匕 彡 髟
彦 : 丷 立 亠 厂 彡
膝 : 月 水 木 ㅅ
菱 : 土 儿 夂 ⺾
肘 : 月 寸
弼 : 弓 白 ノ
必 : ノ 心
畢 : ｜ 一 田
筆 : 竹 聿 乞
逼 : 口 ⻌ 田 一
桧 : 二 木 ㅅ 厶
姫 : 女 臣
媛 : ノ 女 爪 又
紐 : ｜ 一 糸 幺 小
百 : 一 白
謬 : 羽 言 ㅅ 冫 彡
俵 : 衣 ⺅ 士 土 二 亠
彪 : 卜 儿 匕 厂 彡 虍
標 : 示 二 小 西 木
氷 : 水 丶
漂 : 示 二 小 ⺡ 西
瓢 : 瓜 示 二 小 西
票 : 示 二 小 西
表 : 衣 士 土 二 亠
評 : ｜ 一 言 二 丷
豹 : 丶 勹 豸
廟 : 月 十 日 广
描 : 田 心 ⺾
病 : 一 人 冂 ⽧
秒 : ノ 禾 小
苗 : 田 ⺾
錨 : 金 田 ⺾
鋲 : 斤 金 丷 ハ
蒜 : 示 二 小 ⺾
蛭 : 至 虫 土 厶 一
鰭 : 魚 田 日 ⺹ ⺣ 匕
品 : 口 品
彬 : 木 彡
斌 : 止 文 弋
浜 : 斤 ⺡ ハ 一
瀕 : ノ 貝 目 ハ 止 ⺡ 小 頁
貧 : 貝 目 刀 ハ
賓 : ノ 貝 目 ハ 小 宀 一
頻 : ノ 貝 目 ハ 止 小 頁
敏 : 母 攵 毋 乞
瓶 : 瓦 丷 二 一 ノ
不 : ｜ ノ 一 丶
付 : ⺅ 寸
埠 : ｜ 口 十 土 ⻖
夫 : 人 二 大
婦 : ヨ 巾 女 冖
富 : 口 田 宀 一
冨 : 口 田 冖 一
布 : ノ 一 巾
府 : ⺅ 寸 广
怖 : ノ 一 巾 ⺖
扶 : 人 二 心 大
敷 : 十 田 方 丶 攵 乞
斧 : 斤 父
普 : ｜ 一 二 日 丷
浮 : 子 ⺡ 爪
父 : 父
符 : ⺅ 寸 竹 乞
腐 : ⺅ 寸 肉 广
膚 : 月 田 卜 匕 厂 虍
芙 : 人 二 ⺾ 大
譜 : ｜ 一 言 二 日 丷
負 : 貝 目 ハ 勹
賦 : 貝 目 ハ 止 弋
赴 : 走 土 卜
阜 : ⻖ 十 口 ｜
附 : ⺅ 寸 ⻖
侮 : ⺅ 母 毋 乞
撫 : ｜ ノ 一 心 ⺣ 無 乞
武 : 止 弋
舞 : ｜ ノ 一 舛 二 夕 無 乞
葡 : 十 用 勹 ⺾ 丶
蕪 : ｜ ノ 一 ⺣ ⺾ 無 乞
部 : 口 ⻏ 立
封 : 寸 土
楓 : 風 木 几 虫 ノ
風 : 風 几 虫 ノ
葺 : 口 耳 ⺾
蕗 : 口 足 夂 ⺾ 止
伏 : ⺅ 犬
副 : 一 ⺉ 口 田
復 : 日 夂 彳 ノ 一 人 乞
幅 : 一 巾 口 田
服 : 月 又 卩
福 : 一 口 田 ⺭
腹 : 月 日 夂 ノ 一 人 乞
複 : ⻂ 日 夂 乞
覆 : 西 日 夂 彳 乞
淵 : ｜ 一 ⺡
弗 : ｜ ノ 弓
払 : 厶 心
沸 : ｜ ノ 弓 ⺡
仏 : ⺅ 厶
物 : 勿 牛 勹 ノ
鮒 : ⺅ 魚 寸 田 ⺣
分 : 刀 ハ
吻 : 勿 口 勹 ノ
噴 : 貝 目 ハ 口 十 ⺾
墳 : 貝 目 ハ 十 土 ⺾
憤 : 貝 目 ハ 十 ⺖ ⺾
扮 : 刀 ハ 心
焚 : 火 木
奮 : 大 田 隹
粉 : 刀 丷 米 ハ
糞 : ｜ 一 田 二 丷 米 井
紛 : 糸 幺 小 刀 ハ
雰 : 雨 刀 ハ
文 : 文
聞 : 耳 門
丙 : 一 人 冂
併 : ｜ ノ 一 ⺅ 二 丷 廾
兵 : 一 斤 ハ
塀 : ｜ ノ 一 土 二 ハ 尸 廾
幣 : 巾 丷 冂 攵 乞
平 : 干 丷
弊 : ｜ 巾 ⺌ 丷 冂 廾 攵 乞
柄 : 一 人 木 冂
並 : ｜ 一 二 丷
蔽 : ｜ 巾 ⺌ 丷 冂 攵 ⺾ 乞
閉 : ノ 一 門 亅
陛 : 土 比 ⻖
米 : 米
頁 : 貝 目 ハ 頁
僻 : ⺅ 口 十 辛 立 尸
壁 : 口 十 辛 土 立 尸
癖 : 口 十 辛 立 尸 ⽧
碧 : 王 口 石 白
別 : ⺉ 口 力 勹
瞥 : ｜ 巾 ⺌ 丷 目 冂 攵 乞
蔑 : ノ ⺲ 戈 ⺾
箆 : 竹 比 冂 乞
偏 : ｜ 一 ⺅ 戸 冂 冊 尸 廾
変 : 亠 夂
片 : 片
篇 : ｜ 一 戸 竹 冂 冊 尸 廾 乞
編 : ｜ 一 戸 糸 幺 小 冂 冊 尸 廾
辺 : ⻌ 刀
返 : ⻌ 又 厂
遍 : ｜ 一 戸 ⻌ 冂 冊 尸 廾
便 : ｜ ノ 一 ⺅ 日 田
勉 : 力 免 儿 勹
娩 : 女 免 儿 勹
弁 : 厶 廾
鞭 : ノ 一 ⺅ 革 日 田
保 : ⺅ 口 木
舗 : 口 十 土 用 ㅅ 丶
鋪 : 金 十 用 丶
圃 : 十 用 丶 囗
捕 : 十 用 丶 心
歩 : ノ 止 小
甫 : 十 用 丶
補 : 十 ⻂ 用 丶
輔 : 車 十 用 丶
穂 : 禾 十 心 田
募 : 大 日 力 ⺾
墓 : 大 土 日 ⺾
慕 : 心 大 日 ⺾
戊 : ノ 戈
暮 : 大 日 ⺾
母 : 母 毋
簿 : 十 ⺡ 寸 竹 田 丶 乞
菩 : 口 立 ⺾
倣 : ⺅ 方 攵 乞
俸 : ｜ 一 ⺅ 人 大 二
包 : 勹 已
呆 : 口 木
報 : 十 辛 土 又 立 亠 卩
奉 : ｜ 一 人 大 二
宝 : 王 宀 丶
峰 : ｜ 一 山 夂
峯 : ｜ 一 山 夂
崩 : 月 山
庖 : 勹 已 广
抱 : 勹 已 心
捧 : ｜ 一 人 大 二 心
放 : 方 攵 乞
方 : 方
朋 : 月
法 : ⺡ 土 厶
泡 : ⺡ 勹 已
烹 : 口 亅 亠 ⺣
砲 : 口 石 勹 已
縫 : ｜ 一 ⻌ 糸 幺 小 夂
胞 : 月 勹 已
芳 : 方 ⺾
萌 : 月 日 ⺾
蓬 : ｜ 一 ⻌ 夂 ⺾
蜂 : ｜ 一 虫 夂
褒 : 衣 ⺅ 口 小 亠
訪 : 言 方
豊 : ｜ 一 口 豆 日 丷
⻏ : ノ 二 ⻏
鋒 : ｜ 一 金 夂
飽 : 食 勹 已
鳳 : 鳥 几 ⺣
鵬 : 月 鳥 ⺣
乏 : ノ 乙 丶 亠 廴
亡 : 亡 亠
傍 : ⺅ 丷 方 立 亠 冖
剖 : ⺉ 口 立
坊 : 土 方
妨 : 女 方
帽 : 巾 日 目
忘 : 心 亡 亠
⺖ : 亡 ⺖ 亠
房 : 戸 方 一 尸
暴 : ｜ 一 水 二 日 ハ 井
望 : 王 亡 月
某 : 甘 木
棒 : ｜ 一 人 木 二 大
冒 : 日 目
紡 : 糸 幺 小 方
肪 : 月 方
膨 : 月 口 十 土 豆 丷 彡
謀 : 甘 言 木
貌 : 白 儿 豸
貿 : 貝 目 ハ 刀 厶
鉾 : 牛 金 厶
防 : 方 ⻖
吠 : 犬 口
頬 : 貝 目 ハ 人 頁 二 丷 大
北 : 匕 爿
僕 : 王 ⺅ 丷 羊 大 二
卜 : 卜
墨 : 黒 土 里 ⺣
撲 : 王 人 丷 羊 心 二 大
朴 : 卜 木
牧 : 牛 攵 乞
睦 : 土 目 儿
穆 : 禾 小 白 彡
釦 : 金 口
勃 : 子 十 力 冖
没 : ⺡ 殳 几 又
殆 : 口 厶 歹
堀 : ｜ 山 土 尸
幌 : 巾 ⺌ 日 儿
奔 : ノ 一 十 大 廾
本 : 一 木
翻 : 羽 田 釆 米 冫
凡 : 丶 几
盆 : 皿 刀 ハ
摩 : 手 木 广 麻
磨 : 口 石 木 广 麻
魔 : 鬼 田 木 儿 匕 广 麻 厶
麻 : 木 广 麻
埋 : 土 里
妹 : ｜ 女 二 ハ 木 亠
昧 : ｜ 二 日 ハ 木 亠
枚 : 木 攵 乞
毎 : 母 毋 乞
哩 : 口 里
槙 : 十 ハ 木 目
幕 : 巾 大 日 ⺾
膜 : 月 大 日 ⺾
枕 : ノ 乙 木 冖 尢
鮪 : ノ 一 魚 月 田 ⺣
柾 : 一 止 木
鱒 : 魚 寸 田 酉 丷 ⺣
桝 : 舛 木 夕
亦 : ノ ハ 亅 亠
俣 : ⺅ 口 大 二 一
又 : 又
抹 : ｜ 一 ハ 木 亠 心
末 : ｜ 一 ハ 木 亠
沫 : ｜ ⺡ 二 ハ 木 亠
迄 : 乙 ⻌ 乞
侭 : ⺅ 尸 丶
繭 : 糸 幺 小 虫 風 冂 ⺾
麿 : 口 木 广 麻 ノ
万 : ｜ ノ 一
慢 : 日 ⺲ ⺖ 又
満 : ｜ 一 ⺡ 二 冂 山 ⺾
漫 : ⺡ 日 ⺲ 又
蔓 : 日 ⺲ 又 ⺾
味 : ｜ 口 二 ハ 木 亠
未 : ｜ 二 ハ 木 亠
魅 : ｜ 鬼 田 二 ハ 木 亠 儿 匕 厶
巳 : 已
箕 : 甘 竹 ハ 乞
岬 : ｜ 山 日 田
密 : ノ 山 心 丶 宀
蜜 : ノ 心 虫 丶 宀
湊 : 一 ⺡ 大 二 人
蓑 : 衣 一 亠 ⺾
稔 : 禾 心 ㅅ 一
脈 : 斤 月 厂
妙 : ノ 女 小
粍 : 米 毛
民 : 口 氏 尸
眠 : 口 氏 目 尸
務 : 矛 力 攵
夢 : ⺲ 夕 冖 ⺾
無 : ｜ ノ 一 ⺣ 無 乞
牟 : 牛 厶
矛 : 矛 マ
霧 : 雨 矛 力 攵
鵡 : 止 鳥 弋 戈 ⺣
椋 : 口 小 木 亠
婿 : 月 女 疋
娘 : 艮 女
冥 : 日 ハ 亠 冖
名 : 口 夕
命 : 口 ㅅ 卩 一
明 : 月 日
盟 : 月 皿 日
迷 : ⻌ 米
銘 : 金 口 夕
鳴 : 口 鳥 ⺣
姪 : 至 女 土 厶
牝 : 牛 匕
滅 : ノ 火 ⺡ 戈
免 : ｜ 一 勹 口 儿 免
棉 : 巾 白 木
綿 : 巾 糸 幺 小 白
緬 : 糸 幺 小 面
面 : 面
麺 : 麦 面 夂 土 亠 二
摸 : 大 日 心 ⺾
模 : 大 日 木 ⺾
茂 : ノ 戈 ⺾
妄 : 亡 女 亠
孟 : 皿 子
毛 : 毛
猛 : 皿 子 ⺨
盲 : 亡 目 亠
網 : 亡 糸 幺 小 丷 冂
耗 : ｜ 士 ハ 毛 木 耒 ノ
蒙 : 冖 ⺾ 豕
儲 : ⺅ 言 日 ⺹
木 : 木
黙 : 犬 里 ⺣ 黒
目 : 目
杢 : 工 木
勿 : ノ 勹 勿
餅 : ｜ ノ 一 食 二 丷 廾
尤 : 丶 尢 尤
戻 : 戸 大 一 尸
籾 : 刀 米 丶
貰 : 貝 目 ハ 世
問 : 口 門
悶 : 心 門
紋 : 糸 幺 小 文
門 : 門
匁 : ノ 勹 丶
也 : ｜ 乙 匕 也
冶 : 口 冫 厶
夜 : ⺅ 夕 亠
爺 : 耳 父 ⻏
耶 : 耳 ⻏
野 : 矛 里 亅
弥 : ノ 弓 亅 小 乞
矢 : ノ 大 一 矢 乞
厄 : 卩 厂
役 : 彳 殳 几 又
約 : 糸 幺 小 丶 勹
薬 : 日 木 冫 ⺾
訳 : 言 尸 丶
躍 : ヨ 口 足 隹 止
靖 : 月 青 土 二 立 亠
柳 : 木 卩
薮 : 女 米 夂 ⺾ 攵 乞
鑓 : ｜ 一 金 口 ⻌
愉 : ⺉ 月 ⺖ ㅅ 一
愈 : ⺉ 月 心 ㅅ 一
油 : ｜ ⺡ 日 田
癒 : ⺉ 月 心 ㅅ ⽧
諭 : ⺉ 月 言 ㅅ 一
輸 : ⺉ 月 車 ㅅ 一
唯 : 口 隹
佑 : ノ 一 ⺅ 口
優 : 一 ⺅ 心 白 冖 夂 自
勇 : 田 力 マ
友 : ノ 一 又
宥 : ノ 一 月 宀
幽 : ｜ 凵 幺
悠 : ｜ ⺅ 心 夂 攵 乞
憂 : 一 自 心 冖 夂 白
揖 : 口 耳 心
有 : ノ 一 月
柚 : ｜ 日 木 田
湧 : ⺡ 田 力 マ
涌 : ⺡ 用 マ
猶 : 酉 丷 ⺨
猷 : 丷 酉 犬
由 : ｜ 日 田
祐 : ノ 一 口 ⺭
裕 : 口 ⻂ 谷 ハ ㅅ
誘 : 乃 禾 言 ノ
遊 : ⻌ 子 方 乞
邑 : 口 巴
郵 : ｜ ノ 一 ⻏
雄 : ノ 一 厶 隹
融 : 口 虫 儿 冂 鬲
夕 : 夕
予 : マ 一 亅
余 : 一 二 ハ ㅅ 亅 示 小
与 : 勹 一 卜
誉 : 一 言 ⺌ 丷
輿 : 臼 車 ハ
預 : 貝 目 ハ 欠 マ 一 亅 頁
傭 : ヨ ⺅ 用 广 聿
幼 : 力 幺
妖 : ノ 女 大
容 : 穴 口 谷 ハ ㅅ 宀
庸 : ヨ 用 广 聿
揚 : 一 日 心 勿 勿
揺 : 干 爪 凵 心
擁 : 亠 心 隹 幺
曜 : ヨ 日 隹
楊 : 一 日 木 勿 勿
様 : 王 水 丷 木 羊
洋 : 王 ⺡ 丷 羊
溶 : 穴 口 ⺡ 谷 ハ ㅅ 宀
熔 : 火 穴 口 谷 ハ ㅅ 宀
用 : 用
窯 : 王 穴 丷 羊 儿 宀 ⺣
羊 : 王 丷 羊
耀 : ヨ ⺌ 儿 隹
葉 : 木 世 ⺾
蓉 : 穴 口 谷 ハ ㅅ 宀 ⺾
要 : 女 西
謡 : 干 言 爪 凵
踊 : 口 足 用 マ 止
遥 : 干 ⻌ 爪 凵
陽 : 一 日 勿 ⻖ 勿
養 : 王 食 丷 羊
慾 : 欠 口 心 谷 ハ ㅅ
抑 : 卩 心
欲 : 欠 口 谷 ハ ㅅ
沃 : ノ ⺡ 大
浴 : 口 ⺡ 谷 ハ ㅅ
翌 : 羽 立 冫
翼 : ｜ 一 羽 田 二 ハ 冫 井
淀 : ⺡ 疋 宀
羅 : 糸 幺 小 ⺲ 隹
螺 : 糸 幺 小 虫 田
裸 : ⻂ 田 木
来 : ｜ 二 米 亠 木
莱 : ｜ 二 米 亠 ⺾ 木
頼 : ｜ 貝 目 口 ハ 頁 木
雷 : 雨 田
洛 : 口 ⺡ 夂
絡 : 口 糸 幺 小 夂
落 : 口 ⺡ 夂 ⺾
酪 : 口 酉 夂
乱 : 乙 口 舌
卵 : ノ 卜 丶 卩
嵐 : 山 風
欄 : ｜ 一 日 木 門 田
濫 : ノ 皿 ⺡ 臣 二 乞
藍 : ノ 皿 臣 二 ⺾ 乞
蘭 : ｜ 一 日 木 門 ⺾
覧 : ノ 見 臣 二 乞
利 : 禾 ⺉
吏 : ノ 一 口 丶
履 : 日 夂 尸 彳 乞
李 : 子 木
梨 : 禾 ⺉ 木
理 : 王 里
璃 : 王 亠 凵 ⽱
痢 : 禾 ⺉ ⽧
裏 : 衣 里 亠
裡 : ⻂ 里
里 : 里
離 : 亠 凵 ⽱ 隹
陸 : 土 儿 ⻖
律 : 彳 聿
率 : 玄 十 亠 冫 幺
立 : 立
葎 : 彳 聿 ⺾
掠 : 口 小 亠 心
略 : 口 田 夂
劉 : ⺉ 金 厶
流 : ⺡ 川 亠 厶
溜 : ⺡ 刀 厶 田
琉 : 王 川 亠 厶
留 : 田 刀 厶
硫 : 口 石 川 亠 厶
粒 : 米 立
隆 : 生 夂 ⻖
竜 : 立 竜 田 乙
龍 : 月 立
侶 : ⺅ 口 ノ
慮 : 心 田 卜 匕 厂 虍
旅 : ノ 方 乞
虜 : 田 卜 力 匕 厂 虍
了 : 一 亅
亮 : 口 亠 儿 冖
僚 : ⺅ 小 日 大
両 : ｜ 一 冂 山
凌 : 土 儿 冫 夂
寮 : 小 日 丷 大 宀
料 : 斗 米
梁 : ⺡ 刀 木 丶
涼 : 口 ⺡ 小 亠
猟 : ⺌ ⺨ 用 几
療 : 小 日 丷 大 ⽧
瞭 : 小 日 丷 目 大
稜 : 禾 土 儿 夂
糧 : 一 日 米 里
良 : 艮
諒 : 言 口 小 亠
遼 : ⻌ 小 日 丷 大
量 : 一 日 里
陵 : 土 儿 夂 ⻖
領 : 貝 目 ハ 頁 ㅅ 卩 一
力 : 力
緑 : ヨ 糸 幺 小 水 隶
倫 : ｜ 一 ⺅ ㅅ 亅 冊 廾
厘 : 里 厂
林 : 木
淋 : ⺡ 木
燐 : 火 舛 米 夕
琳 : 王 木
臨 : ノ 口 臣 品 一 人 乞
輪 : ｜ 一 車 ㅅ 冊 廾
隣 : 舛 米 夕 ⻖
鱗 : 魚 舛 田 米 夕 ⺣
麟 : 鹿 舛 比 米 夕 广
瑠 : 王 田 刀 厶
塁 : 田 土 冫
涙 : 戸 ⺡ 大 一 尸
累 : 糸 幺 小 田
類 : 貝 目 ハ 大 米 頁
令 : ㅅ 卩 一
伶 : ㅅ 卩 一 ⺅
例 : ⺅ ⺉ 歹
冷 : ㅅ 冫 卩 一
励 : 斤 力 厂
嶺 : 貝 目 ハ 山 頁 ㅅ 卩 一
怜 : ⺖ ㅅ 卩 一
玲 : 王 ㅅ 卩 一
⺭ : 乙 ⺭
苓 : ㅅ 卩 ⺾ 一
鈴 : 金 ㅅ 卩 一
隷 : ヨ 士 小 水 二 隶 示
零 : 雨 ㅅ 卩 一
霊 : ｜ 一 雨 二
麗 : 一 鹿 比 冂 广
齢 : 止 歯 米 ㅅ 凵 卩 一
暦 : 日 麻 木 厂 广
歴 : 止 麻 木 厂 广
列 : ⺉ 歹
劣 : ノ 小 力
烈 : ⺉ ⺣ 歹
裂 : 衣 ⺉ 歹 亠
廉 : ｜ ヨ ハ 广 丷
恋 : 心 ハ 亠
憐 : 舛 米 ⺖ 夕
漣 : ⻌ 車 ⺡
煉 : ｜ 一 火 日 ハ 木 田
簾 : ｜ ヨ 竹 ハ 广 乞
練 : ｜ 糸 幺 小 日 ハ 木 田
聯 : 耳 幺
蓮 : ⻌ 車 ⺾
連 : ⻌ 車
錬 : ｜ 一 金 日 木 田 丷 ハ
呂 : 口 ノ
魯 : 魚 田 日 ⺣
櫓 : 魚 田 日 木 ⺣
炉 : 火 戸 一 尸
賂 : 貝 目 ハ 口 夂
路 : 口 足 夂 止
露 : 雨 口 足 夂 止
労 : ⺌ 力 冖
婁 : ｜ 一 口 女
廊 : 艮 ⻏ 广
弄 : 王 廾
朗 : 月 艮
楼 : 女 米 木
榔 : 艮 ⻏ 木
浪 : 艮 ⺡
漏 : 雨 ⺡ 尸
牢 : 牛 宀
狼 : 艮 ⺨
篭 : 竹 立 竜 乞
⺹ : ⺹ 匕
聾 : 月 耳 立
蝋 : ｜ 一 ⺌ 虫 用 几
郎 : 艮 ⻏
六 : ハ 亠
麓 : 鹿 比 木 广
禄 : ヨ 水 ⺭ 隶
肋 : 月 力
録 : ヨ 金 水 隶
論 : ｜ 一 言 ㅅ 冊 廾
倭 : ⺅ 禾 女
和 : 禾 口
話 : 言 口 舌
歪 : ｜ ノ 一 止 丶
賄 : ノ 一 貝 目 ハ 月
脇 : 月 力
惑 : 口 心 戈
枠 : 九 十 木
鷲 : 口 小 鳥 丶 亠 尤 ⺣ 尢
亙 : ノ 一 二 丶
亘 : 一 二 日
鰐 : 魚 口 田 二 ⺣ 勹
詫 : ノ 乙 言 宀
藁 : 口 高 木 亠 冂 ⺾
蕨 : 欠 丷 厂 屮 ⺾
椀 : 木 夕 卩 宀
湾 : 弓 ⺡ 亠
碗 : 口 石 夕 卩 宀
腕 : 月 夕 卩 宀
弌 : 一 弋
丐 : 一 弓 止 疋
丕 : ｜ ノ 一 丶
ㅅ : ｜ ㅅ
丱 : ｜ ノ 丶
丶 : 丶
丼 : ｜ ノ 二 丶 廾 井
丿 : ノ
乂 : ノ 丶
乖 : ノ 十 匕 爿
乘 : ノ 十 ハ 匕 爿 禾
亂 : 乙 爪 冂 厶
亅 : 亅
豫 : 勹 口 ｜ 矛 亅 豕 マ
亊 : ヨ 一 丷 亅
舒 : 干 口 舌 矛 ㅅ 亅 マ
弍 : 二 弋
于 : 二 亅
亞 : 一 二
亟 : 口 二 又
亠 : 亠
亢 : 亠 几
亰 : 小 日 亠
亳 : ノ 一 乙 口 亠 冖
亶 : 一 口 日 亠 囗
从 : 人
仍 : ノ ⺅ 乃
仄 : 人 厂
仆 : ⺅ 卜
仂 : ⺅ 力
仗 : ノ ⺅ 一 丶
仞 : ⺅ 刀 丶
仭 : ⺅ 刀 丶
仟 : ノ ⺅ 十
价 : 儿 ⺅ ㅅ
伉 : ⺅ 亠 几
佚 : ノ ⺅ 人 大 二
估 : ⺅ 口 十
佛 : ｜ ノ ⺅ 弓
佝 : ⺅ 口 勹
佗 : ⺅ 匕 宀
佇 : ⺅ 亅 宀 一
佶 : ⺅ 口 士
侈 : ⺅ 夕
侏 : ノ ⺅ 牛 ハ 木
侘 : ノ 乙 ⺅ 宀
佻 : ⺅ 儿 冫
佩 : ⺅ 巾 几 一
佰 : ⺅ 白 一
侑 : ノ 一 ⺅ 月
佯 : 王 ⺅ 丷 羊
來 : ｜ 一 十 人 ハ 木
侖 : ㅅ 冂 廾 冊 廾 一
儘 : ヨ ⺅ 皿 ⺣
俔 : ⺅ 見
俟 : ⺅ 矢 厶 乞
俎 : 人 目
俘 : ⺅ 子 爪
俛 : ⺅ 免 儿 勹
俑 : ⺅ 用 マ
俚 : ⺅ 里
俐 : ⺅ 禾 ⺉
俤 : ｜ ノ ⺅ 弓 丷
俥 : ⺅ 車
倚 : ⺅ 口 大 亅 一
倨 : ⺅ 口 十 尸
倔 : ｜ ⺅ 山 尸
倪 : 臼 ⺅ 儿
倥 : ⺅ 穴 工 儿 宀
倅 : ⺅ 十 人 亠
伜 : 九 ⺅ 十
俶 : ⺅ 小 卜 又
倡 : ⺅ 日
倩 : ⺅ 月 青 土 二 亠
倬 : ⺅ 十 日 卜 曰
俾 : ⺅ 十 田 ノ
俯 : ⺅ 寸 广
們 : ⺅ 門
倆 : ｜ ⺅ 人 冂
偃 : ⺅ 女 日 匚
假 : ｜ ⺅ 又
會 : 日 ⺲ ㅅ 一
偕 : ⺅ 白 比
偐 : ⺅ 丷 立 亠 厂 彡
偈 : ⺅ 日 勹 匕 人 一 ｜
做 : ⺅ 口 十 攵 乞
偖 : ⺅ 日 ⺹
偬 : 丶 ⺅ 心 勿 勿
偸 : ⺅ ⺉ 月 ㅅ 一
傀 : ⺅ 鬼 田 儿 匕 厶
傚 : ⺅ 父 亠 攵 乞
傅 : ⺅ 寸 田 丶
傴 : ⺅ 口 匚 品
傲 : ⺅ 土 方 攵 亠 二 乞
僉 : 口 人 ㅅ 一
僊 : ⺅ 西 大 已
傳 : ⺅ 寸 田 厶 十
僂 : ⺅ 十 女
僖 : ⺅ 口 士 十 豆 丷
僞 : ⺅ 爪 ⺣
僥 : ⺅ 土 儿
僭 : ⺅ 日 亠 无
僣 : ⺅ 日 二 大
僮 : ⺅ 里 立
價 : ⺅ 貝 目 ハ 西
僵 : 一 ⺅ 田 二
儉 : ⺅ 口 人 ㅅ 一
儁 : ⺅ 隹
儂 : ｜ ⺅ 辰 日 衣
儖 : ⺅ 皿 臣 二 乞
儕 : ⺅ 刀 亠 齊 氏 廾
儔 : ⺅ 口 工 士 寸
儚 : ⺅ ⺲ 夕 冖 ⺾
儡 : ⺅ 田
儺 : ⺅ ⺾ 隹 二 大 井
儷 : ⺅ 鹿 比 冂 广
儼 : ⺅ 口 耳 厂 攵 乞
儻 : ⺅ 口 黒 ⺌ 里 冖 ⺣
儿 : 儿
兀 : 一 儿
兒 : 臼 儿
兌 : 口 丷 儿
兔 : 免 丶 儿 勹
兢 : 口 十 儿
竸 : 音 日 立 儿
兩 : ｜ 一 入 冂
兪 : 月 入 ㅅ 一
兮 : 弓 ハ
冀 : 田 二 ハ 匕 爿
冂 : 冂
囘 : 冂 已
册 : 一 冂
冉 : ｜ 一 冂 十
冏 : 口 儿 冂
冑 : 月 田 二 冂
冓 : ｜ 一 冂 二 十
冕 : 月 免 二 儿 冂 勹
冖 : 冖
冤 : 免 丶 冖 儿 勹
冦 : 元 卜 又 儿 冖
冢 : 冖 豕 丶
冩 : 臼 冖 勹 ⺣
冪 : 巾 大 日 冖 ⺾
冫 : 冫
决 : ノ 人 冫 ユ 大
冱 : 一 二 冫 彑
冲 : ｜ 口 冫
冰 : 水 冫
况 : 口 儿 冫
冽 : ⺉ 冫 歹
凅 : 口 十 冫 囗
凉 : 口 小 亠 冫
凛 : 口 示 二 小 亠 冫 囗
几 : 几
處 : 卜 几 匕 厂 夂 虍
凩 : 木 几
凭 : ノ ⺅ 士 几
凰 : 王 白 几
凵 : 凵
凾 : 口 又 凵
刄 : 刀
刋 : ノ ⺉ 十
刔 : ⺉ 人 ユ 大
刎 : ⺉ 勿 勹 ノ
刧 : 土 刀 厶
刪 : ⺉ 冊 冂 廾
刮 : ⺉ 口 舌
刳 : ⺉ 大 二 勹
刹 : ⺉ 木 ノ 丶
剏 : ｜ ノ 刀 二 丷 廾 一
剄 : ⺉ 工 巛 一
剋 : ⺉ 口 十 儿
剌 : ｜ ⺉ 口 ハ 木
剞 : ⺉ 口 大 亅 一
剔 : ⺉ 日 勿 勿
剪 : 一 ⺉ 月 丷 刀
剴 : ⺉ 口 山 豆 丷
剩 : ｜ ⺉ 匕 爿 禾
剳 : ⺉ 口 ㅅ ⺾ 一
剿 : ⺉ ⺌ 田 木 巛
剽 : ⺉ 示 二 小 西
劍 : ⺉ 口 人 ㅅ 一
劔 : 口 人 刀 ㅅ 丶 一
劒 : 口 人 ㅅ 丶 刀 一
剱 : 口 人 刀 ㅅ 丶
劈 : 口 十 辛 刀 立 尸
劑 : ⺉ 亠 齊 刀 氏 廾
辨 : ノ 十 辛 立
辧 : 十 辛 刀 立
劬 : 口 力 勹
劭 : 口 刀 力
劼 : 口 士 力
劵 : 人 大 二 ハ 力
勁 : 工 巛 力
勍 : 口 小 力 亠
勗 : 日 目 力
勞 : 火 力 冖
勣 : 貝 目 ハ 土 力 亠 二
勦 : ⺌ 田 木 力 巛
飭 : 食 力 乞
勠 : 羽 力 ㅅ 冫 彡
勳 : ｜ 力 ⺣
勵 : 田 力 厂 ⽱
勸 : 口 十 力 ⺾ 隹
勹 : 勹
匆 : 丶 勿 勹 ノ
匈 : 凵 勹
甸 : 田 勹
匍 : 十 用 丶 勹
匐 : 一 口 田 勹
匏 : 大 二 勹 已
匕 : 匕
匚 : 匚
匣 : ｜ 田 匚
匯 : ⺡ 匚 隹
匱 : 貝 目 ハ 匚 口 亠 ｜ 一 口
匳 : 口 人 ㅅ 匚 一
匸 : 匚
區 : 口 匚 品
卆 : 九 十
卅 : ｜ ノ 一 十 川
丗 : ｜ 山 十
卉 : 十 廾
卍 : ｜ 一 十
凖 : 十 冫 隹
卞 : 卜 亠
卩 : 卩
卮 : 卩 厂
夘 : 夕 卩
卻 : 口 ハ 卩 谷
卷 : 人 大 二 ハ 卩 丷
厂 : 厂
厖 : 丶 厂 尤 彡 尢
厠 : 貝 目 ハ ⺉ 厂
厦 : 一 自 厂 夂
厥 : 欠 丷 厂 屮
厮 : 甘 斤 ハ 厂
厰 : 口 ⺌ 冂 厂 攵 乞
厶 : 厶
參 : ㅅ 厶 彡
簒 : 大 竹 目 厶 乞
雙 : 又 隹
叟 : 臼 支 又 十
曼 : 日 ⺲ 又
燮 : 火 言 又
叮 : 口 亅 一
叨 : 口 刀
叭 : 口 ハ
叺 : 口 入
吁 : 口 二 亅
吽 : ｜ 牛 口 二
呀 : 牙 口
听 : 斤 口
吭 : 口 亠 几
吼 : 乙 口 子
吮 : 口 儿 厶
吶 : 口 人 冂
吩 : 口 刀 ハ
吝 : 口 文
呎 : 口 尸 丶
咏 : ノ 口 水 丶
呵 : 口 亅
咎 : 口 人 夂
呟 : 玄 口 亠 幺
呱 : 瓜 口
呷 : ｜ 口 田
呰 : 口 止 匕
咒 : 口 几
呻 : ｜ 口 田
咀 : 一 口 目
呶 : 口 女 又
咄 : ｜ 口 山
咐 : ⺅ 口 寸
咆 : 口 勹 已
哇 : 口 土
咢 : 口 二 勹
咸 : ノ 口 戈
咥 : 口 至 土 厶
咬 : 口 父 亠
哄 : ｜ 一 口 二 ハ
哈 : 口 ㅅ 一
咨 : 欠 口 冫
咫 : 口 ハ 尸 丶
哂 : 口 西
咤 : ノ 乙 口 宀
咾 : 口 ⺹ 匕
咼 : 口 冂
哘 : 口 行 彳
哥 : 一 口 亅
哦 : 口 亅 戈
唏 : ノ 一 巾 口
唔 : 口 五
哽 : ノ 口 田 一
哮 : 口 子 ⺹
哭 : 犬 口
哺 : 口 十 用 丶
哢 : 王 口 廾
唹 : 口 方 ㅅ 冫
啀 : 口 土 厂
啣 : 口 止 凵 卩 乞
啌 : 穴 口 工 儿 宀
售 : 口 隹
啜 : 口 又
啅 : 口 十 日 卜
啖 : 火 口
啗 : 臼 口 勹
唸 : 口 心 ㅅ 一
唳 : 戸 口 大 一 尸
啝 : 禾 口
喙 : ヨ 口 豕
喀 : 口 夂 宀
咯 : 口 夂
喊 : ノ 口 戈
喟 : 月 口 田
啻 : 巾 口 丷 立 亠 冖
啾 : 火 禾 口
喘 : ｜ 一 口 山 而 冂
喞 : 口 艮 卩
單 : 口 十 田
啼 : 巾 口 丷 立 亠 冖
喃 : 干 口 十 丷 冂
喩 : ⺉ 月 口 ㅅ 一
喇 : ｜ ⺉ 口 ハ 木 亠
喨 : 口 亠 儿 冖
嗚 : 口 鳥 ⺣
嗅 : 口 自 大 目 犬
嗟 : ノ 王 口 工 丷 羊
嗄 : 一 口 自 夂
嗜 : 口 日 ⺹ 匕
嗤 : 口 山 虫
嗔 : 口 十 ハ 目
嘔 : 口 匚 品
嗷 : 口 土 方 攵 乞
嘖 : 貝 目 ハ 口 土 亠 二
嗾 : 口 方 矢 乞
嗽 : ｜ 欠 口 ハ 木
嘛 : 口 麻 木 广
嗹 : 口 ⻌ 車
噎 : 口 士 豆 丷 冖
噐 : 口 工
營 : 火 口 冖 ノ
嘴 : 角 口 止 匕
嘶 : 甘 斤 口 ハ
嘲 : 月 口 十 日
嘸 : ｜ ノ 一 口 ⺣ 無 乞
噫 : 音 口 心 日 立
噤 : 口 示 二 小 木
嘯 : ｜ ノ ヨ 口 水 米 隶 聿
噬 : 口 工 人 竹 乞
噪 : 口 木 品
嚆 : 口 高 亠 冂 ⺾
嚀 : 口 心 ⺲ 宀 皿
嚊 : 口 自 田 廾 鼻 目
嚠 : ⺉ 金 口 厶 刀
嚔 : 口 十 田 冖 疋
嚏 : 口 十 田 疋 冖
嚥 : 一 口 凵 匕 ⺣ 爿
嚮 : 口 艮 ⻏ 冂 幺
嚶 : 貝 目 ハ 口 女
嚴 : 口 耳 厂 攵 乞
囂 : 一 口 ハ 頁 貝 目
嚼 : 口 艮 寸 爪 ⺲
囁 : 口 耳
囃 : 口 人 木 亠 隹
囀 : 口 車 十 寸 田 厶
囈 : 九 口 土 二 丶 儿 厶 ⺾
囎 : 貝 目 口 田 日 ハ 丷
囑 : 口 虫 ⺲ 勹 尸
囓 : 口 止 歯 土 刀 米 亠 凵 二
囗 : 囗 口
囮 : ⺅ 匕 囗
囹 : 刀 ㅅ 囗 一
圀 : 方 儿 囗
囿 : ノ 一 月 囗
圄 : 口 囗 五
圉 : 干 十 辛 土 立 亠 囗
圈 : 人 大 二 丷 卩 囗
國 : 口 囗 戈
圍 : 口 囗 韋
圓 : 貝 目 ハ 口 囗
團 : 十 寸 厶 囗 田
圖 : 口 囗
嗇 : 口 人 土 囗
圜 : 衣 一 口 ⺲ 囗
圦 : 土 入
圷 : 土 卜 一
圸 : 山 土
坎 : 欠 土
圻 : 斤 土
址 : 止 土
坏 : ｜ ノ 一 土 丶
坩 : 甘 土
埀 : ノ 土 匕 爿
垈 : ⺅ 土 弋
坡 : 土 皮 又
坿 : ⺅ 寸 土
垉 : 土 勹 已
垓 : 人 土 亠 ノ 丶
垠 : 艮 土
垳 : 行 土 彳
垤 : 至 土 厶
垪 : ｜ ノ 土 二 丷 廾 一
垰 : 土 卜
埃 : 土 矢 厶 乞
埆 : 角 土
埔 : 十 土 用 丶
埒 : 寸 爪 土
埓 : ノ 寸 土
堊 : 一 土 二
埖 : ⺅ 土 匕 ⺾
埣 : 十 人 土 亠
堋 : 月 土
堙 : ｜ 一 西 土
堝 : 口 土 冂
塲 : 土 日 勿 一 乞
堡 : ⺅ 口 土 木
塢 : 鳥 土 ⺣
塋 : 火 土 冖
塰 : ⺡ 土 母 毋 乞
毀 : 臼 土 殳 几 又
塒 : 寸 土 日
堽 : 止 土 ⺲
塹 : 斤 車 土
墅 : 土 里 マ
墹 : 土 日 門
墟 : ｜ 一 土 丷 卜 匕 厂 虍
墫 : 寸 土 酉 丷
墺 : 大 土 米 冂 釆
壞 : 衣 土 ⺲ 亠
墻 : 口 人 土 囗
墸 : 土 日 ⺹ ⺾
墮 : 月 工 土 ⻖
壅 : 土 亠 隹 幺
壓 : 月 犬 土 日 厂
壑 : 口 土 ハ 卜 又 ㅅ 冖 谷
壗 : ヨ 皿 土 ⺣ 聿
壙 : ｜ 一 黄 田 土 二 ハ 广
壘 : 田 土
壥 : 黒 土 里 厂 ⺣
壜 : 雨 土 二 日 厶
壤 : ｜ 衣 一 口 土 亠 二
壟 : 月 土 立
壯 : 士 爿
壺 : 一 士 冖
壹 : 口 士 豆 丷 冖
壻 : 月 土 疋
壼 : 一 士 二 冖
壽 : 一 口 工 士 寸
夂 : 夂 攵
夊 : 夂
夐 : 目 冂 夂 勹 人
夛 : ヨ 夕
梦 : 木 夕
夥 : 田 木 夕
夬 : 人 大 二 ユ
夭 : ノ 大
夲 : 十 大
夸 : 大 二 勹
夾 : 人 大
竒 : 一 口 丷 立 亅 亠
奕 : 赤 大 ハ 亠
奐 : 大 儿 冂 勹
奎 : 大 土
奚 : 大 爪 幺
奘 : 士 大 爿
奢 : 大 日 ⺹
奠 : 大 酉 丷
奧 : 大 米 冂 釆
奬 : 寸 大 爿 夕
奩 : 口 大 匚 品
奸 : 干 女
妁 : 女 丶 勹
妝 : 女 爿
佞 : ⺅ 女 二
侫 : 亡 ⺅ 女
妣 : 女 比
妲 : 女 日 一
姆 : 女 母 毋
姨 : 弓 女 人 大
姜 : 王 女 丷 羊
妍 : ｜ ノ 一 女 二 廾
姙 : ノ ⺅ 士 女
姚 : 女 儿 冫
娥 : 女 亅 戈
娟 : 月 口 女
娑 : ノ ⺡ 女 小
娜 : 女 刀 ⻏ 二
娉 : ｜ 女 田 一 勹
娚 : 女 田 力
婀 : 口 女 亅 ⻖ 一
婬 : ノ 士 女 爪
婉 : 女 夕 卩 宀
娵 : 耳 女 又
娶 : 耳 女 又
婢 : 十 女 田
婪 : 女 木
媚 : 女 目 尸 ｜
媼 : 皿 女 日
媾 : ｜ 一 女 二 冂 十
嫋 : 弓 女 冫
嫂 : ｜ 女 田 又
媽 : 女 馬 ⺣
嫣 : 一 止 女 鳥 ⺣
嫗 : 口 女 匚 品
嫦 : 巾 口 女 ⺌
嫩 : ｜ 口 女 ハ 木 攵 乞
嫖 : 示 二 小 女 西
嫺 : 女 日 門
嫻 : 女 木 門
嬌 : ノ 口 女 大 冂
嬋 : ｜ 口 十 女 田
嬖 : 口 十 女 辛 立 尸
嬲 : 女 田 力
嫐 : 女 田 力
嬪 : ノ 貝 目 ハ 女 小 宀
嬶 : 自 女 田 鼻 目 廾
嬾 : ｜ 貝 目 口 女 ハ 頁 木
孃 : ｜ 衣 一 口 女 亠
孅 : 女 人 戈 韭
孀 : 雨 女 木 目
孑 : 子
孕 : 乃 子 ノ
孚 : 子 爪
孛 : 士 子 十 冖
孥 : 子 女 又
孩 : 子 亠 ノ 丶
孰 : 九 口 子 丶 亠
孳 : 一 子 丷 幺
孵 : 子 爪 丶 卩
學 : 臼 子 冖
斈 : 子 文
孺 : ｜ 一 雨 子 而 冂
宀 : 宀
它 : 匕 宀
宦 : 臣 宀
宸 : 衣 辰 厂 宀
寃 : 免 丶 儿 宀 勹
寇 : 二 卜 又 儿 宀 元
寉 : 宀 隹
寔 : 日 疋 宀
寐 : 二 ハ 亅 宀 爿
寤 : 口 宀 爿 五
實 : 一 貝 目 ハ 田 宀
寢 : ヨ 又 冖 宀 爿
寞 : 大 日 宀 ⺾
寥 : 羽 ㅅ 冫 宀 彡
寫 : 臼 勹 宀 ⺣
寰 : 衣 一 口 ⺲ 宀
寶 : 王 貝 目 ハ 缶 凵 宀
寳 : 王 貝 目 ハ 小 宀 乞
尅 : 口 十 寸 儿
將 : 寸 夕 爿
專 : 一 十 寸 虫 田 厶
對 : 王 寸 丷 羊
尓 : ノ 小 乞
尠 : ノ 甘 小 儿 匚
尢 : 尢
尨 : 丶 尤 彡 尢
尸 : 尸
尹 : ノ ヨ 一
屁 : 比 尸
屆 : 士 土 凵 尸
屎 : 米 尸
屓 : 貝 目 ハ 尸
屐 : 支 尸 彳 又 十
屏 : ｜ ノ 二 丷 尸 廾 一
孱 : 子 尸
屬 : 虫 ⺲ 勹 尸
屮 : 屮
乢 : 乙 山
屶 : 山 刀
屹 : ノ 乙 山 乞
岌 : 及 山
岑 : 山 ㅅ 一
岔 : 山 刀 ハ
妛 : 一 山 女
岫 : ｜ 山 田
岻 : 山 氏 一
岶 : 山 白
岼 : ｜ 干 山 二 ハ
岷 : 口 山 氏 尸
峅 : 山 厶 廾
岾 : 口 山 卜
峇 : 口 山 ㅅ 一
峙 : 山 寸 土
峩 : 山 亅 戈
峽 : 山 人 大
峺 : ノ 一 山 田
峭 : 月 山 ⺌
嶌 : 山 鳥 ⺣
峪 : 口 山 ハ ㅅ 谷
崋 : ｜ 一 山
崕 : 山 土 厂
崗 : 山 丷 冂 凵 岡
嵜 : 一 口 山 丷 立 亅 亠 大
崟 : 金 山
崛 : ｜ 山 尸
崑 : 山 日 比
崔 : 山 隹
崢 : ヨ 山 爪 亅 尸
崚 : 山 土 儿 夂
崙 : ｜ 一 山 ㅅ 冊 廾
崘 : ｜ 一 山 ㅅ 冊 廾
嵌 : 甘 欠 山
嵒 : 口 山 品
嵎 : 山 田 ⽱
嵋 : 山 目 尸 ｜
嵬 : 鬼 山 田 儿 匕 厶
嵳 : 王 工 山 丷 羊
嵶 : 弓 山 冫
嶇 : 口 山 匚 品
嶄 : 斤 山 車
嶂 : 音 山 十 日 立 曰
嶢 : 山 土 儿
嶝 : 口 山 豆 丷 癶
嶬 : 王 山 丷 羊 亅 戈
嶮 : 口 山 人 ㅅ 一
嶽 : 犬 言 山
嶐 : 山 生 夂 ⻖
嶷 : 山 疋 矢 匕 乞
嶼 : 臼 山 ハ
巉 : 山 比 丶 儿 勹 口
巍 : 禾 鬼 山 女 田 儿 匕 厶
巓 : 貝 山 十 ハ 頁 目
巒 : 言 山 糸 幺 小
巖 : 口 山 耳 厂 攵 乞
巛 : 巛
巫 : 工 人
已 : 已
巵 : 一 厂 巴
帋 : 巾 氏
帚 : ヨ 巾 冖
帙 : ノ 巾 人 大 二
帑 : 巾 女 又
帛 : 巾 白
帶 : 一 巾 儿 冖 凵
帷 : 巾 隹
幄 : 巾 至 土 厶 尸
幃 : 巾 韋 口
幀 : 貝 目 ハ 巾 卜
幎 : 巾 日 ハ 亠 冖
幗 : 巾 口 囗 戈
幔 : 巾 日 ⺲ 又
幟 : 音 巾 日 立 戈
幢 : 巾 里 立
幤 : 巾 口 ⺌ 冂 攵 乞
幇 : 巾 寸 土
幵 : 干
丷 : ノ 干 二 丷 一
幺 : 幺
麼 : 木 幺 广 麻
广 : 广
庠 : 王 丷 羊 广
廁 : 貝 目 ハ ⺉ 广
廂 : 木 目 广
廈 : 一 自 夂 广
廐 : 艮 广 无
廏 : 艮 广 殳 几 又
廖 : 羽 ㅅ 冫 广 彡
廣 : 黄 田 ハ 广
廝 : 甘 斤 ハ 广
廚 : 口 士 寸 豆 丷 广
廛 : 土 里 儿 广
廢 : 弓 广 殳 癶 几 又
廡 : ｜ 一 广 ⺣ 無 ノ 乞
廨 : 角 牛 刀 广
廩 : 禾 口 亠 囗 广
廬 : 皿 田 卜 匕 厂 广 虍
廱 : 口 巛 巴 广 隹
廳 : 一 王 耳 十 心 ⺲ 广
廰 : 耳 十 心 ⺲ 广
廴 : 廴
廸 : ｜ 日 廴
廾 : 廾
弃 : 亠 厶 廾
弉 : 士 廾 爿
彝 : ヨ 糸 幺 小 米 廾 彑
彜 : ヨ 刀 丷 米 廾 彑
弋 : 弋
弑 : 工 木 弋
弖 : 一 弓
弩 : 弓 女 又
弭 : 弓 耳
弸 : 弓 月
彁 : 弓 口 亅 一
彈 : ｜ 弓 口 十 田
彌 : ｜ 一 弓 ハ 冂 爻
彎 : 弓 言 糸 幺 小
弯 : 弓 赤 ハ 亠
彑 : ヨ 彑
彖 : 彑 豕
彗 : ヨ 二 亠 土
彙 : ヨ 田 木 冖 彑
彡 : 彡
彭 : 口 土 豆 丷 彡
彳 : 彳
彷 : 方 彳
徃 : 生 彳
徂 : 目 彳
彿 : ｜ ノ 弓 彳
徊 : 口 囗 彳
很 : 艮 彳
徑 : 一 工 巛 彳
徇 : 日 勹 彳
從 : 人 疋 彳
徙 : 止 疋 彳
徘 : 非 彳
徠 : ｜ 人 ハ 木 彳
徨 : 王 白 彳
徭 : 缶 夕 凵 彳
徼 : 白 方 夂 彳
忖 : 寸 ⺖
忻 : 斤 ⺖
忤 : ノ 干 ⺖ 十 乞
忸 : ｜ 一 ⺖
忱 : ⺖ 儿 冖 尢
忝 : ノ 心 大 一 二
悳 : 十 心 目
忿 : 心 刀 ハ
怡 : 口 ⺖ 厶
恠 : ノ 一 土 ⺖
怙 : 口 十 ⺖
怐 : 口 ⺖ 勹
怩 : ⺖ 匕 尸
怎 : ｜ ノ 一 心 乞
怱 : ノ 心 丶 勿 勹
怛 : 日 ⺖ 一
怕 : 白 ⺖
怫 : ｜ ノ 弓 ⺖
怦 : 干 ハ ⺖
怏 : 人 大 ⺖ 冂 冖
怺 : 水 ⺖ 丶
恚 : 心 土
恁 : ノ ⺅ 士 心
恪 : 口 ⺖ 夂
恷 : ⺅ 心 木
恟 : ⺖ 凵 勹
恊 : ⺖ 力
恆 : ｜ 一 ⺖ 彑
恍 : ⺌ ⺖ 儿
恣 : 欠 心 冫
恃 : 寸 土 ⺖
恤 : 血 皿 ⺖
恂 : 日 ⺖ 勹
恬 : 口 舌 ⺖
恫 : 口 ⺖ 冂 一
恙 : 王 心 丷 羊
悁 : 月 口 ⺖
悍 : 干 日 ⺖
惧 : ハ ⺖ 目
悃 : ⺖ 木 囗
悚 : ｜ 口 ハ ⺖ 木
悄 : 月 ⺌ ⺖
悛 : ⺖ 儿 厶 夂
悖 : 子 十 ⺖ 冖
悗 : 免 ⺖ 儿 勹
悒 : 口 ⺖ 巴 邑
悧 : 禾 ⺉ ⺖
悋 : 口 文 ⺖
惡 : 一 心 二
悸 : 禾 子 ⺖
惠 : ｜ 一 心 虫 日 厶
惓 : 大 二 丷 ⺖ 已
悴 : 十 人 ⺖ 亠
忰 : 九 十 ⺖
悽 : ヨ 女 ⺖
惆 : 口 土 ⺖ 冂
悵 : 長 ⺖
惘 : 工 丷 ⺖ 冂
慍 : 皿 日 ⺖
愕 : 口 二 ⺖ 勹
愆 : 行 ⺡ 心 彳
惶 : 王 白 ⺖
惷 : 心 大 二 日
愀 : 火 禾 ⺖
惴 : 山 而 ⺖
惺 : 生 日 ⺖
愃 : 二 日 ⺖ 宀 一
愡 : ノ 心 ⺖ 丶 勿 勹
惻 : 貝 目 ハ ⺉ ⺖
惱 : 巛 ⺖ 囗
愍 : 口 氏 心 攵 尸 乞
愎 : 日 ⺖ 夂 乞
慇 : 心 日 殳 几 又
愾 : 米 ⺖ 气 乞
愨 : 士 心 冖 殳 几 又
愧 : 鬼 田 ⺖ 儿 匕 厶
慊 : ｜ ヨ 丷 ⺖
愿 : 小 心 白 厂
愼 : ハ ⺖ 目 匕
愬 : 月 心 丷 屮
愴 : 戸 口 人 ⺖ 一 尸
愽 : 十 寸 田 ⺖ 丶
慂 : ⺡ 心 用 マ
慄 : 西 ⺖ 木
慳 : 臣 土 ⺖ 又
慷 : ヨ 水 ⺖ 广 隶
慘 : ⺖ ㅅ 厶 彡
慙 : 斤 車 心
慚 : 斤 車 ⺖
慫 : 心 丷 疋 彳
慴 : 羽 白 ⺖ 冫
慯 : ノ 一 日 ⺖ 勹 勿 乞
慥 : 口 ⻌ 土 ⺖
慱 : 十 寸 虫 田 ⺖ 亠 厶
慟 : ｜ ノ 日 ⺖ 力
慝 : ノ 一 口 心 厂 ⺾ 匚
慓 : 示 二 小 西 ⺖
慵 : ヨ ⺖ 用 冂 广 聿
憙 : 一 口 士 心 豆 ハ
憖 : ｜ 犬 心 人 ハ 木
憇 : 甘 口 心 舌
憬 : 口 小 日 ⺖ 亠
憔 : ⺖ ⺣ 隹
憚 : ｜ 口 十 田 ⺖
憊 : ⺅ 心 用 厂 ⺾
憑 : 心 馬 冫 ⺣
憫 : 文 ⺖ 門
憮 : ⺖ ⺣ 無 一 ｜ ノ 乞
懌 : 十 辛 土 ⺲ ⺖ 立 亠
懊 : 大 米 ⺖ 冂 釆
應 : ⺅ 心 广 隹
懷 : 衣 ⺲ ⺖ 亠
懈 : 角 牛 刀 ⺖
懃 : 心 力 ⺾ 土 口 二
懆 : 口 ⺖ 木 品
憺 : 言 ⺖ 儿 厂 勹
懋 : 心 矛 木 マ
罹 : ⺲ ⺖ 隹
懍 : 禾 口 ⺖ 亠 囗
懦 : 雨 而 ⺖
懣 : ｜ 一 ⺡ 心 入 冂 凵
懶 : ｜ 貝 目 口 ハ 頁 ⺖ 木
懺 : 人 ⺖ 戈 韭
懴 : 土 ⺖ 戈 韭
懿 : 欠 口 士 心 豆 丷 冖 冫
懽 : 口 十 ⺖ ⺾ 隹
懼 : ⺖ 目 隹
懾 : 耳 ⺖
戀 : 言 糸 幺 小 心
戈 : 戈
戉 : 戈
戍 : ノ 丶 戈 厂
戌 : ノ 戈 丶 厂
戔 : 戈
戛 : 一 自 戈 白 目
戞 : 一 自 冖 戈
戡 : 甘 儿 匚 戈
截 : 土 戈 隹
戮 : 羽 ㅅ 冫 彡 戈
戰 : ｜ 口 十 田 戈
戲 : 口 豆 丷 卜 匕 厂 戈 虍
戳 : ヨ 戈 隹
扁 : ｜ 一 戸 冂 冊 尸 廾
心 : 乙 心
扞 : 干 心
扣 : 口 心
扛 : 工 心
扠 : 又 丶 心
扨 : 刀 心 丶
扼 : 卩 厂 心
抂 : 王 心
抉 : 人 大 二 心 ユ
找 : 戈 心
抒 : 矛 亅 心 マ
抓 : 爪 心
抖 : 斗 心
拔 : ノ 一 丶 心
抃 : 卜 亠 心
抔 : ｜ ノ 一 丶 心
拗 : 力 幺 心
拑 : 甘 心
抻 : ｜ 日 心 田
拏 : 手 女 又
拿 : 口 手 ㅅ 一
拆 : 斤 丶 心
擔 : 言 儿 厂 心 勹
拈 : 口 卜 心
拜 : ノ 干 心
拌 : ｜ 干 二 ハ 心 十
拊 : ⺅ 寸 心
拂 : ｜ ノ 弓 心
拇 : 母 心 毋
抛 : ノ 九 心 力
拉 : 立 心
挌 : 口 夂 心
拮 : 口 士 心
拱 : ｜ 一 二 ハ 心
挧 : 羽 冫 心
挂 : 土 心
挈 : 手 土 刀
拯 : 水 心
拵 : ノ 一 子 心
捐 : 月 口 心
挾 : 人 大 心
捍 : 干 日 心
搜 : ｜ 臼 支 又 心 十
捏 : 土 日 心
掖 : ⺅ 丶 亠 夂 心 夕
掎 : 口 大 亅 心 一
掀 : 斤 欠 心
掫 : 耳 又 心
捶 : ｜ ノ 二 心
掣 : ⺉ 缶 牛 巾 手 凵
掏 : 缶 凵 勹 心
掉 : 十 日 卜 心 曰
掟 : 疋 宀 心
掵 : 口 ㅅ 卩 心 一
捫 : 門 心
捩 : 戸 大 心 一 尸
掾 : ヨ 心 豕
揩 : 白 比 心
揀 : ｜ 日 ハ 木 心
揆 : 人 大 二 心 癶
揣 : 山 而 心
揉 : 矛 木 心 マ
插 : ノ 臼 十 心
揶 : 耳 ⻏ 心
揄 : ⺉ 月 ㅅ 心 一
搖 : 缶 夕 凵 心
搴 : ｜ 一 手 二 ハ 宀
搆 : ｜ 一 黄 冂 心 十
搓 : 王 工 丷 羊 心
搦 : 弓 冫 心
搶 : 戸 口 ㅅ 心 一 尸
攝 : 耳 心
搗 : 山 鳥 心
搨 : 羽 日 冫 心
搏 : 十 寸 田 丶 心
摧 : 山 心 隹
摯 : ノ 九 手 十 辛 立 丶
摶 : 十 寸 虫 田 厶 心
摎 : 羽 ㅅ 冫 彡 心
攪 : 臼 見 心
撕 : 甘 斤 ハ 心
撓 : 土 儿 心
撥 : 二 儿 心 癶
撩 : 小 人 大 日 丷 亠 心
撈 : 火 力 冖 心
撼 : ノ 口 心 戈 心
據 : 卜 匕 厂 心 虍 豕
擒 : ㅅ 亠 凵 心 ⽱
擅 : 口 日 亠 囗 心 一
擇 : 十 辛 土 ⺲ 立 亠 心
撻 : 王 ⻌ 十 辛 土 羊 立 亠 心
擘 : 口 手 十 辛 立 尸
擂 : 雨 田 心
擱 : 口 門 夂 心
擧 : 臼 手 ハ
舉 : ｜ 一 臼 二 ハ
擠 : 亠 心 齊 刀 氏 廾
擡 : 口 士 至 土 冖 厶 心
抬 : 口 厶 心
擣 : 口 工 士 寸 心
擯 : ノ 貝 目 ハ 小 宀 心
攬 : 見 臣 心 乞
擶 : ⺉ 月 竹 丷 心
擴 : 黄 田 ハ 广 心
擲 : 大 酉 丷 ⻏ 心
擺 : 月 ⺲ 匕 厶 心
攀 : 一 手 大 ハ 木 爻
擽 : 白 木 冫 心 幺
攘 : 衣 二 ハ 亠 心 口
攜 : 口 山 儿 冂 心 隹
攅 : 貝 目 ハ 人 大 土 亠 心 二
攤 : 二 心 ⺾ 隹 井
攣 : 言 糸 幺 小 手
攫 : 又 目 心 隹
攴 : 攵
攵 : 攵 乞
攷 : 攵 乞
收 : ｜ 攵 乞
攸 : ｜ ノ 攵 乞
畋 : 田 攵 乞
效 : 父 亠 攵 乞
敖 : 土 方 攵 亠 二 乞
敕 : ｜ 口 ハ 木 攵 乞
敍 : 干 小 ㅅ 攵 一
敘 : 干 小 ㅅ 攵 一 乞
敞 : 口 ⺌ 冂 攵 乞
敝 : ｜ 巾 ⺌ 丷 冂 攵 乞
敲 : 口 高 亠 冂 攵
數 : ｜ 一 口 女 攵 乞
斂 : 口 人 ㅅ 攵 一 乞
斃 : 巾 小 ⺌ 丷 夕 冂 匕 攵 乞
變 : 言 糸 幺 小 攵 乞
斛 : 角 斗
斟 : 甘 斗 儿 匚
斫 : ノ 斤 口 石
斷 : ｜ 斤 幺
旃 : 方 冂 乞
旆 : 干 缶 巾 方 凵 乞
旁 : 丷 方 立 亠 冖
旄 : 方 毛 乞
旌 : 生 方 乞
旒 : 川 方 亠 厶 乞
旛 : 田 釆 米 方 乞
旙 : 田 釆 米 方
无 : 无
旡 : 无
旱 : 干 日
杲 : 日 木
昊 : 一 大 日 二
昃 : 人 日 厂
旻 : 日 文
杳 : 日 木
昵 : 日 匕 尸
昶 : 水 日 丶
昴 : 日 卩
昜 : ノ 一 日 勿 勹
晏 : 女 日 宀
晄 : ⺌ 日 儿
晉 : 一 二 日 厶
晁 : 日 儿 冫
晞 : ノ 一 巾 日
晝 : 一 日 聿
晤 : 口 日 五
晧 : ノ 口 土 日
晨 : 辰 日 衣
晟 : ノ 日 戈
晢 : 斤 日 心
晰 : 斤 日 木
暃 : 日 非
暈 : 車 日 冖
暎 : 人 大 日 冂 ⺾ 冖
暉 : 車 日 冖
暄 : 一 二 日 宀
暘 : ノ 一 日 勹 勿
暝 : 日 ハ 亠 冖
曁 : 一 艮 日 无 匕 白
暹 : ⻌ 日 隹
曉 : 土 日 儿
暾 : 口 子 日 亠 攵 乞
暼 : 巾 小 ⺌ 日 丷 冂 攵 乞
曄 : ｜ 一 二 日 ⺾
暸 : 小 大 日 丷 亠
曖 : 心 爪 日 冖 夂
曚 : 日 冖 ⺾ 豕
曠 : 黄 田 日 ハ 广
昿 : 日 厶 广
曦 : 王 日 丷 羊 亅 戈
曩 : ｜ 衣 一 日 ハ 亠 井
曰 : 曰
曵 : 弋 曰
曷 : 日 勹 匕 曰
朏 : ｜ 月 山
朖 : 月 艮
朞 : 一 甘 月 ハ
朦 : 月 冖 ⺾ 豕
朧 : 月 立
霸 : 雨 革 月
朮 : ｜ 一 木 丶 儿
朿 : ｜ 一 ハ 木 冂
朶 : ノ 木 乃
杁 : 入 木
朸 : 木 力
朷 : 刀 木
杆 : 干 木
杞 : 木 已
杠 : 工 木
杙 : 木 弋
杣 : 山 木
杤 : ノ 一 木
枉 : 王 木
⺣ : 木 ⺣
枩 : ハ 木 厶
杼 : 矛 木 亅
杪 : ノ 小 木
枌 : 刀 ハ 木
枋 : 方 木
枦 : 戸 木 一 尸
枡 : ノ 木 廾
枅 : 木 廾 二 一 ノ
枷 : 口 木 力
柯 : 口 木 亅 一
枴 : 口 刀 木
柬 : 巾 丷 木 亠
枳 : 口 ハ 木
柩 : 入 木 匚 久
枸 : 口 木 勹
柤 : 木 目
柞 : ｜ ノ 木
柝 : 斤 木 丶
柢 : 氏 木
柮 : ｜ 山 木
枹 : 木 勹 已
柎 : ⺅ 寸 木
柆 : 木 立
柧 : 瓜 木
檜 : 日 ⺲ 木 ㅅ 一
栞 : 干 木
框 : 王 木 匚
栩 : 羽 木 冫
桀 : 舛 木 夕
桍 : 大 二 木 勹
栲 : 木 ⺹ 勹
桎 : 至 土 木 厶 一
梳 : 川 木 亠 厶
栫 : ノ 一 子 木
桙 : 牛 木 厶
档 : ヨ ⺌ 木
桷 : 角 木
桿 : 干 日 木
梟 : 鳥 木
梏 : ノ 口 土 木
梭 : 木 儿 厶 夂
梔 : 木 厂 巴
條 : ⺅ 木 攵 乞 ｜
梛 : 刀 ⻏ 木 二
梃 : 王 木 廴
檮 : 口 工 士 寸 木
梹 : 斤 ハ 木 一
桴 : 子 爪 木
梵 : 木 丶 几
梠 : 口 木 ノ
梺 : 一 卜 木
椏 : 一 二 木
梍 : 乙 白 木 匕
桾 : ヨ 口 木 尸
椁 : 口 子 木 亠
棊 : 一 甘 ハ 木
椈 : 米 木 勹
棘 : ｜ 巾 ハ 木 亠 冂
椢 : 王 木 囗
椦 : 大 二 丷 木 力
棡 : 丷 木 冂 凵 山 岡
椌 : 穴 工 木 儿
棍 : 日 比 木
棔 : 氏 日 木
棧 : 木 戈
棕 : 示 二 小 木 宀
椶 : 木 儿 凵 夂
椒 : 小 卜 又 木
椄 : 女 木 立
棗 : ｜ 一 巾 ハ 木 亠 冂
棣 : ヨ 水 木 隶
椥 : 口 木 矢 乞
棹 : 十 日 卜 木
棠 : 口 ⺌ 木 冖
棯 : 心 木 ㅅ 一
椨 : ⺅ 寸 木 广
椪 : ｜ 一 丷 木
椚 : 木 門
椣 : ｜ 一 日 ハ 木
椡 : ⺉ 至 土 木 厶
棆 : ｜ 一 木 ㅅ 冊 廾
楹 : ノ 皿 又 木 乃
楷 : 白 比 木
楜 : 月 口 十 木
楸 : 火 禾 木
楫 : 口 耳 木
楔 : 大 土 刀 木 亠 二
楾 : 水 白 木
楮 : 日 木 ⺹
椹 : 甘 木 儿 匚
楴 : 巾 丷 木 立 亠 冖
椽 : ヨ 木 豕
楙 : 矛 木
椰 : 耳 ⻏ 木
楡 : ⺉ 月 木 ㅅ 一
楞 : ⺲ 方 木
楝 : 巾 ハ 木 亠
榁 : 至 土 木 厶 宀
楪 : 木 世
榲 : 皿 日 木
榮 : 火 木 冖
槐 : 鬼 田 木 儿 匕 厶
榿 : 口 山 豆 丷 木
槁 : 口 高 木 亠 冂
槓 : 貝 目 ハ 工 木
榾 : 月 口 木 冖 骨
槎 : ノ 王 工 丷 木 羊
寨 : ｜ 一 ハ 木 宀
槊 : 月 丷 木 屮
槝 : 山 鳥 木
榻 : 羽 日 木 冫
槃 : 舟 木 殳 几 又
榧 : 非 木 匚
樮 : 火 西 木
榑 : 十 寸 田 木 丶
榠 : 日 ハ 木 亠 冖
榜 : 丷 方 木 立 亠 冖
榕 : 穴 口 ハ 木 ㅅ 宀 谷
榴 : 田 刀 木 厶
槞 : 木 立 竜
槨 : 口 子 ⻏ 木 亠
樂 : 白 木 幺
樛 : 羽 木 ㅅ 冫 彡
槿 : 土 二 木 ⺾ 口
權 : 口 十 木 ⺾ 隹
槹 : 十 斗 白 木
槲 : 角 斗 木
槧 : 斤 車 木
樅 : 丷 疋 木 彳
榱 : 衣 木 亠
樞 : 口 木 匚 品
槭 : 小 卜 木 戈
樔 : ⺌ 田 木 巛
槫 : 十 寸 虫 田 木 厶
樊 : 木 大 爻
樒 : ノ 山 心 木 丶 宀
櫁 : ノ 心 虫 木 丶 宀
樣 : 王 水 丷 木 羊 丶
樓 : ｜ 一 口 女 木
橄 : 耳 木 攵 乞
樌 : 貝 目 ハ 田 木
橲 : 口 士 十 豆 丷 木
樶 : 耳 日 又 木
橸 : 日 木
橇 : 毛 木
橢 : ノ 一 月 工 木 ⻖
橙 : 口 豆 丷 木 癶
橦 : 木 里 立
橈 : 土 木 儿
樸 : 二 丷 木 羊
樢 : 鳥 木 ⺣
檐 : 言 木 儿 厂
檍 : 音 心 日 木 立
檠 : 口 木 勹 攵 ⺾ 乞
檄 : 白 方 木 攵 乞
檢 : 口 人 木 ㅅ 一
檣 : 口 人 土 木 囗
檗 : 口 十 辛 木 立 尸
蘗 : 口 十 辛 木 立 尸 ⺾
檻 : 皿 臣 二 木 乞
櫃 : 一 貝 目 ハ 木 匚 ｜ 口
櫂 : ヨ 木 隹
檸 : 一 心 ⺲ 木 亅 宀 皿
檳 : ノ 貝 目 ハ 小 木 宀
檬 : 木 冖 ⺾ 豕
櫞 : ヨ 糸 幺 小 木 豕
櫑 : 田 木
櫟 : 白 木 幺
檪 : 白 木 冫
櫚 : 口 木 門 ノ
櫪 : 止 木 厂
櫻 : 貝 目 ハ 女 木
欅 : ⺌ ハ 木 手
蘖 : 口 十 辛 木 立 ⺾ ｜
櫺 : 雨 口 木
欒 : 言 糸 幺 小 木
欖 : 見 臣 二 木 乞
鬱 : 缶 木 冖 凵 匕 彡 鬯
欟 : 見 口 十 木 ⺾ 隹
欸 : 欠 矢 厶 乞
欷 : ノ 一 巾 欠
盜 : 欠 皿 ⺡
欹 : 欠 口 大 亅 一
飮 : ｜ 欠 ㅅ 食
歇 : 欠 日 勹 匕
歃 : ノ 臼 欠 十
歉 : ｜ ヨ 欠 丷
歐 : 欠 口 匚 品
歙 : 羽 欠 口 ㅅ 冫
歔 : 欠 丷 卜 匕 厂 虍
歛 : 欠 口 人 ㅅ 一
歟 : 一 臼 欠 ハ
歡 : 欠 口 十 ⺾ 隹
歸 : ヨ 巾 口 止 冖 ｜
歹 : 歹
歿 : 又 歹 勹
殀 : ノ 大 歹
殄 : ㅅ 彡 歹
殃 : 人 大 冂 歹 冖
殍 : 子 爪 歹
殘 : 戈 歹
殕 : 口 立 歹
殞 : 貝 目 ハ 口 歹
殤 : ノ 一 日 勿 歹 勹 乞
殪 : 口 士 豆 丷 冖 歹
殫 : 口 十 田 歹
殯 : ノ 貝 目 ハ 小 宀 歹
殲 : 人 戈 歹 韭
殱 : 土 戈 歹 韭
殳 : 殳 几 又
殷 : 厂 殳 几 又
殼 : 土 儿 冖 殳 几 又
毆 : 口 匚 殳 品 几 又
毋 : 母 毋
毓 : 川 母 亠 厶 毋 乞
毟 : ノ 小 毛
毬 : 水 毛 丶 亠
毫 : 口 毛 亠 冖
毳 : 毛
毯 : 火 毛
麾 : 毛 木 广 麻
氈 : 口 毛 目 亠 囗 日 一
氓 : 亡 口 氏 尸
气 : 气 乞
氛 : 刀 ハ 气 乞
氤 : 大 囗 气 乞
氣 : 米 气 乞
汞 : 工 水
汕 : 山 ⺡
汢 : ⺡ 土
汪 : 王 ⺡
沂 : 斤 ⺡
沍 : ヨ 一 ⺡ 彑
沚 : 止 ⺡
沁 : ⺡ 心
沛 : 巾 ⺡ 亠
汾 : ⺡ 刀 ハ
汨 : ⺡ 日
汳 : ⺡ 又 厂
沒 : ⺡ 又 力
沐 : ⺡ 木
泄 : ⺡ 世
泱 : ⺡ 人 大 冂 冖
泓 : 弓 ⺡ 厶
沽 : 口 十 ⺡
泗 : ⺡ 儿 囗
泅 : ⺡ 人 囗
泝 : 斤 ⺡ 丶
沮 : ⺡ 目
沱 : ⺡ 匕 宀
沾 : 口 ⺡ 卜
沺 : ⺡ 田
泛 : ノ 乙 ⺡ 亠
泯 : 口 氏 ⺡ 尸
泙 : 干 ⺡ ハ
泪 : ⺡ 目
洟 : 弓 ⺡ 人 大
衍 : 行 ⺡ 彳
洶 : ⺡ 凵 勹
洫 : 血 皿 ⺡
洽 : 口 ⺡ ㅅ 一
洸 : ⺡ ⺌ 儿
洙 : ｜ ノ 牛 ⺡ 土 二 ハ 木
洵 : ⺡ 日 勹
洳 : 口 ⺡ 女
洒 : ⺡ 西
洌 : ⺉ ⺡ 歹
浣 : ⺡ 二 儿 宀
涓 : 月 口 ⺡
浤 : ノ 一 ⺡ 厶 宀
浚 : ⺡ ハ 厶 夂
浹 : ⺡ 人 大
浙 : 斤 ⺡ 心
涎 : ノ 止 ⺡ 廴
涕 : ｜ ノ 弓 ⺡ 丷
濤 : 口 工 士 ⺡ 寸
涅 : ⺡ 土 日
淹 : 乙 ⺡ 大 日 奄
渕 : ⺉ ⺡ 人 大 二 丷
渊 : ｜ ノ ⺡ 米
涵 : 一 ⺡ 水 凵
淇 : 甘 ⺡ ハ
淦 : 金 ⺡
涸 : 口 十 ⺡ 囗
淆 : ノ 一 月 ⺡
淬 : 十 ⺡ 人 亠
淞 : ⺡ ハ 木 厶
淌 : 口 ⺡ ⺌ 冂
淨 : ヨ ⺡ 爪 亅
淒 : ｜ ヨ 一 ⺡ 女
淅 : 斤 ⺡ 木
淺 : ⺡ 戈
淙 : 示 二 小 ⺡ 宀
淤 : ⺡ 方 ㅅ 冫
淕 : ⺡ 土 儿
淪 : ｜ 一 ⺡ ㅅ 冊 廾
淮 : ⺡ 隹
渭 : 月 ⺡ 田
湮 : ⺡ 西 土
渮 : 口 ⺡ 亅 ⺾
渙 : ⺡ 大 儿 冂
湲 : ノ 一 ⺡ 爪 二 又
湟 : 王 ⺡ 白
渾 : 車 ⺡ 冖
渣 : ⺡ 木 目
湫 : 火 禾 ⺡
渫 : ⺡ 木 世
湶 : ⺡ 水 白
湍 : 山 而 ⺡
渟 : 口 ⺡ 亅 亠 冖
湃 : 干 ⺡ 心
渺 : ノ ⺡ 小 目
湎 : 一 ⺡ 面 囗
渤 : 子 十 ⺡ 力 冖
滿 : 一 ⺡ 人 入 冂 凵
渝 : ⺉ 月 ⺡ ㅅ 一
游 : 子 ⺡ 方 乞
溂 : ｜ ⺉ 口 ⺡ ハ 木
溪 : ⺡ 大 爪 幺
溘 : 皿 ⺡ 土 厶
滉 : ⺡ ⺌ 日 儿
溷 : ⺡ 囗 豕
滓 : 十 ⺡ 辛 立 宀
溽 : ⺡ 寸 辰 衣
溯 : 月 ⺡ 丷 屮
滄 : 戸 口 ⺡ ㅅ 一 尸
溲 : 支 ⺡ 日 又 十
滔 : 臼 ⺡ 爪
滕 : 月 人 水 大 二 丷
溏 : ｜ ヨ 口 ⺡ 广
溥 : 十 ⺡ 寸 田 丶
滂 : ⺡ 丷 方 立 亠 冖
溟 : ⺡ 日 ハ 亠 冖
潁 : 貝 目 ハ 水 頁 匕
漑 : 艮 ⺡ 无
灌 : 口 十 ⺡ ⺾ 隹
滬 : 戸 口 ⺡ 巴 一 尸
滸 : 干 言 ⺡ 乞
滾 : 衣 口 ⺡ ハ 亠
漿 : 水 寸 夕 爿
滲 : ⺡ 大 厶 彡
漱 : 欠 口 ⺡ 木
滯 : 一 巾 ⺡ 儿 冖 凵
漲 : 弓 ⺡ 長
滌 : ⺅ ⺡ 木 攵 乞 ｜
漾 : 王 ⺡ 水 丷 羊 丶
漓 : ⺡ 亠 凵 ⽱
滷 : 十 ⺡ 卜 囗 鹵
澆 : ⺡ 土 儿
潺 : 子 ⺡ 尸
潸 : 月 ⺡ 木
澁 : 止 ⺡
澀 : 止 ⺡ 刀 丶
潯 : ヨ 口 工 ⺡ 寸
潛 : ⺡ 日 无
濳 : ⺡ 土 日 儿
潭 : 十 ⺡ 西 日 曰
澂 : 王 山 ⺡ 攵 乞
潼 : ⺡ 里 立
潘 : ⺡ 田 釆 米
澎 : 口 十 ⺡ 土 豆 丷 彡
澑 : ｜ 一 ⺡ 田
濂 : ｜ ヨ ⺡ ハ 广
潦 : ⺡ 小 大 日 丷 亠
澳 : ⺡ 大 米 冂 釆
澣 : 干 十 ⺡ 日 ㅅ
澡 : 口 ⺡ 木 品
澤 : 十 ⺡ 辛 土 ⺲ 立 亠
澹 : 言 ⺡ 儿 厂
濆 : 貝 目 ハ 十 ⺡ ⺾
澪 : 雨 ⺡ ㅅ 卩 一
濟 : ⺡ 亠 齊 刀 氏 廾
濕 : ⺡ 日 幺 ⺣
濬 : ⺡ ハ 卜 目 ㅅ 冖
濔 : ｜ 一 ⺡ ハ 冂 爻
濘 : ⺡ 心 ⺲ 亅 宀 皿
濱 : ノ 貝 目 ハ ⺡ 小 宀
濮 : 王 ⺅ ⺡ 大 丷 羊
濛 : ⺡ 冖 ⺾ 豕
瀉 : 臼 ⺡ 勹 宀 ⺣
瀋 : ⺡ 田 釆 米 宀
濺 : 貝 目 ハ ⺡ 戈
瀑 : ｜ 一 ⺡ 水 二 日 ハ
瀁 : 王 ⺡ 食 丷 羊
瀏 : ⺉ 金 ⺡
濾 : ⺡ 田 心 厂 卜
瀛 : 亡 月 口 ⺡ 女 丶 几
瀚 : 羽 十 ⺡ 日 ㅅ 冫
潴 : ⺡ 日 ⺨ ⺹
瀝 : 止 ⺡ 木 厂
瀘 : 皿 ⺡ 田 卜 匕 厂 虍
瀟 : ｜ ノ ヨ ⺡ 水 ⺾
瀰 : ｜ 一 弓 ⺡ ハ 冂 爻
瀾 : ｜ ⺡ 田 日 木 門
瀲 : 口 ⺡ 人 ㅅ 攵 一 乞
灑 : 鹿 ⺡ 比 冂 广
灣 : 弓 言 糸 幺 小 ⺡
炙 : 火 夕 丶
炒 : ノ 火 小
炯 : 火 口 冂
烱 : 火 口 儿 冂
炬 : 火 匚 巨
炸 : ｜ ノ 火
炳 : 一 火 人 冂
炮 : 火 勹 已
烟 : 火 大 囗
烋 : ⺅ 木 ⺣
烝 : 一 水 亅 ⺣
烙 : 火 口 夂
焉 : 一 止 ⺣
烽 : ｜ 火 二 夂
焜 : 火 日 比
焙 : 火 口 立
煥 : 火 大 儿 冂
煕 : 臣 匚 已 ⺣
熈 : ノ 臣 卩 已 ⺣
煦 : 口 日 勹 ⺣
煢 : 乙 火 十 冖
煌 : 王 火 白
煖 : ノ 一 火 爪 又
煬 : ノ 火 日 勿 一 勹
熏 : ｜ ノ 田 日 ⺣
燻 : ｜ ノ 火 田 日
熄 : 火 自 心 目
熕 : 火 貝 目 ハ 工
熨 : 火 示 二 小 寸 尸
熬 : 土 方 攵 ⺣ 乞
燗 : 火 月 門
熹 : 口 士 十 豆 丷 ⺣
熾 : 音 火 日 立 戈
燒 : 火 土 儿
燉 : 火 口 子 亠 攵 乞
燔 : 火 田 釆 米
燎 : 火 小 大 日 丷 亠
燠 : 火 大 米 冂 釆
燬 : 臼 王 火 殳 几 又
燧 : 火 ⻌ 丷 豕
燵 : 火 ⻌ 土 丷 立 亠 二
燼 : ｜ ヨ 火 皿 ⺣ 聿
燹 : 火 豕
燿 : ヨ 火 隹
爍 : 火 白 木 冫
爐 : 火 皿 田 卜 匕 厂 虍
爛 : ｜ 火 日 ハ 木 門
爨 : 火 口 ハ 木 冂 冖 一 大 口 臼
爭 : ヨ 爪 亅
爬 : 爪 已 巴
爰 : ノ 一 爪 又
爲 : 爪 尸 ⺣
爻 : 爻
爼 : 目 爻
爿 : 爿
牀 : 木 爿
牆 : 口 人 土 囗 爿
牋 : 片 戈
牘 : 貝 目 ハ 士 片 儿 囗
牴 : 牛 氏
牾 : 牛 口 五
犂 : ノ 禾 牛 勿
犁 : 禾 ⺉ 牛
犇 : 牛
犒 : 牛 口 高 亠 冂
犖 : 火 牛 冖
犢 : 貝 目 ハ 牛 士 儿 囗
犧 : 王 禾 牛 丷 羊 戈
犹 : ⺨ 丶 尤 尢
犲 : ノ 一 ⺨ 亅
狃 : ｜ 一 ⺨
狆 : ｜ 口 ⺨
狄 : 火 ⺨
狎 : ｜ 日 ⺨ 田
狒 : ｜ ノ 弓 ⺨
狢 : 口 ⺨ 夂
狠 : 艮 ⺨
狡 : ⺨ 父 亠
狹 : 人 大 ⺨
狷 : 月 口 ⺨
倏 : ⺅ 犬 夂 攵 ｜
猗 : 口 大 ⺨ 亅 一
猊 : 臼 ⺨ 儿
猜 : 月 青 土 二 ⺨ 亠
猖 : 日 ⺨
猝 : 十 人 ⺨ 亠
猴 : ⺅ ⺨ 矢 乞
猯 : 山 而 ⺨
猩 : 生 日 ⺨
猥 : 衣 田 ⺨
猾 : 月 骨 ⺨ 冂 冖
獎 : 犬 寸 夕 爿
獏 : 大 日 ⺨ ⺾
默 : 犬 里 ⺣ 黒
獗 : 欠 丷 ⺨ 厂 屮
獪 : 日 ⺲ ⺨ ㅅ 一
獨 : 虫 ⺲ ⺨ 勹
獰 : 心 ⺲ ⺨ 亅 宀 皿
獸 : 一 犬 口 田
獵 : 臼 乙 口 巛 鼠 ⺨
獻 : 犬 口 卜 儿 冂 匕 厂 虍 鬲
獺 : 貝 目 ハ 口 ⺨ 頁 木
珈 : 王 口 力
玳 : 王 ⺅ 弋
珎 : 王 小 乞
玻 : 王 皮 又
珀 : 王 白
珥 : 王 耳
珮 : 王 巾 几
珞 : 王 口 夂
璢 : ｜ 一 王 田
琅 : 王 艮
瑯 : 王 艮 ⻏
琥 : 王 卜 儿 匕 厂 虍
珸 : 王 口 五
琲 : 王 非
琺 : 王 ⺡ 土 厶
瑕 : ｜ 王 又
琿 : 王 車 冖
瑟 : ノ 王 心 丶
瑙 : 王 巛 囗
瑁 : 王 目 冂
瑜 : 王 ⺉ 月 ㅅ 一
瑩 : 王 火 冖
瑰 : 王 鬼 田 儿 匕 厶
瑣 : 王 貝 目 ハ ⺌
瑪 : 王 馬 ⺣
瑶 : 王 缶 爪 凵
瑾 : ｜ 一 王 口 ⺾ 土 二
璋 : 王 音 十 日 立 曰
璞 : 王 人 丷 羊 二 大
璧 : 王 口 十 辛 立 尸
瓊 : 王 目 冂 夂
瓏 : 王 月 立
瓔 : 王 貝 目 ハ 女
珱 : 王 女 ⺌
瓠 : 瓜 大
瓣 : 瓜 十 辛 立
瓧 : 瓦 十
瓩 : ノ 瓦 十
瓮 : 瓦 ハ 厶
瓲 : 瓦 屯
瓰 : 瓦 刀 ハ
瓱 : 瓦 毛
瓸 : 一 瓦 白 日
瓷 : 瓦 欠 冫
甄 : 瓦 西 土
甃 : 火 禾 瓦
甅 : 瓦 里 厂
甌 : 瓦 口 匚 品
甎 : 瓦 十 寸 虫 田 亠
甍 : 瓦 ⺲ 冖 ⺾
甕 : 瓦 亠 幺 隹
甓 : 瓦 口 十 辛 立 尸
甞 : 甘 口 ⺌ 冖
甦 : 一 生 日 田 ノ
甬 : 用
甼 : 一 田 亅
畄 : ⺌ 田
畍 : ｜ ノ 田 ㅅ
畊 : ｜ ノ 田 二 井
畉 : 人 田 二 大
畛 : 田 ㅅ 彡
畆 : 田 亠 厶
畚 : 大 田 厶
畩 : 衣 田 亠
畤 : 寸 田 土
畧 : 口 田 夂
畫 : 一 田 聿
畭 : 工 小 田 ㅅ 一
畸 : 口 大 田 亅 一
當 : 口 ⺌ 田 冖
疆 : 一 弓 田 土
疇 : 口 工 士 寸 田
畴 : ノ 一 寸 田 二
疊 : 田 目 冖
疉 : ヨ 田 宀
疂 : 田 目 冖 冫
⽧ : 一 亅 ⽧
疚 : ノ 入 ⽧ 久
疝 : 山 ⽧
疥 : ｜ ノ ㅅ ⽧
疣 : 丶 尤 ⽧ 尢
痂 : 口 力 ⽧
疳 : 甘 ⽧
痃 : 亠 幺 ⽧ 玄
疵 : 止 匕 ⽧
疽 : 目 ⽧
疸 : 一 日 ⽧
疼 : 冫 夂 ⽧ 丶
疱 : 勹 已 ⽧
痍 : 弓 人 大 ⽧
痊 : 王 ㅅ ⽧
痒 : 王 丷 羊 ⽧
痙 : 工 巛 ⽧
痣 : 士 心 ⽧
痞 : ｜ ノ 一 口 丶 ⽧
痾 : 口 亅 ⽧ ⻖ 一
痿 : 禾 女 ⽧
痼 : 口 十 囗 ⽧
瘁 : 十 人 亠 ⽧
痰 : 火 ⽧
痺 : 十 田 ⽧
痲 : 十 木 儿 ⽧
痳 : 木 ⽧
瘋 : 風 ⽧ 虫 几
瘍 : ノ 一 日 勹 ⽧ 勿
瘉 : ⺉ 月 ㅅ ⽧ 一
瘟 : 皿 日 ⽧
瘧 : 卜 匕 厂 ⽧ 虍
瘠 : 月 ⽧ 人 二
瘡 : 口 ㅅ 尸 ⽧ 一
瘢 : 舟 殳 ⽧ 几 又
瘤 : 田 刀 厶 ⽧
瘴 : 音 十 日 立 曰 ⽧
瘰 : 糸 幺 小 田 ⽧
瘻 : ｜ 一 口 女 ⽧
癇 : 日 門 ⽧
癈 : 二 儿 ⽧ 癶
癆 : 火 力 冖 ⽧
癜 : ハ 尸 殳 ⽧ 几 又
癘 : 田 ⽧ ⽱ ⺾
癡 : 疋 矢 匕 ⽧ 乞
癢 : 王 食 丷 羊 ⽧
癨 : 雨 ⽧ 隹
癩 : 貝 目 ハ 口 頁 木 ⽧
癪 : 禾 貝 目 ハ 土 二 亠 ⽧
癧 : 止 木 厂 ⽧
癬 : 王 丷 羊 ⽧ 魚 田 ⺣
癰 : 口 巛 巴 ⽧ 隹
癲 : 貝 十 ハ 頁 目 ⽧
癶 : 癶
癸 : 大 二 癶 一
發 : 弓 殳 癶 几 又
皀 : 白 匕
皃 : 白 儿
皈 : 白 又 厂
皋 : 十 大 白
皎 : 白 父 亠
皖 : 二 白 儿 宀 元
皓 : ノ 口 土 白
皙 : 斤 白 木
皚 : 口 山 豆 白 丷
皰 : 皮 又 勹 已
皴 : 皮 又 儿 厶 夂
皸 : 車 皮 又 冖
皹 : 車 皮 又 冖
皺 : 皮 又 勹 屮
盂 : 皿 二 亅
盍 : 皿 土 厶
盖 : 王 皿 丷 羊
盒 : 口 皿 ㅅ 一
盞 : 皿 戈
盡 : ヨ 皿 聿
盥 : 臼 皿 水
盧 : 皿 田 卜 匕 厂 虍
盪 : ノ 皿 ⺡ 日 勹 一
蘯 : ノ 皿 ⺡ 日 勹 ⺾ 一
盻 : ハ 目 一 勹
眈 : 目 尢 冖
眇 : ノ 小 目
眄 : 目 一 山 亅
眩 : 玄 目 亠 幺
眤 : 目 匕 尸
眞 : ハ 目 匕
眥 : 止 目 匕
眦 : 止 目 匕
眛 : ｜ 二 ハ 木 目
眷 : 人 大 二 丷 目
眸 : 牛 目 厶
睇 : ｜ ノ 弓 丷 目
睚 : 土 目 厂
睨 : 臼 目 儿
睫 : ｜ ヨ 走 土 目
睛 : 月 青 土 二 目 亠
睥 : 十 田 目
睿 : ハ 卜 目 ㅅ 冖
睾 : 十 辛 土 ⺲ 目 立 亠
睹 : 日 目 ⺹
瞎 : 口 土 二 目 亠 宀
瞋 : 十 ハ 目
瞑 : 日 ハ 目 亠 冖
瞠 : 口 ⺌ 土 目 冖
瞞 : ｜ 一 入 目 冂 凵
瞰 : 耳 目 攵 乞
瞶 : ｜ 一 貝 ハ 口 目
瞹 : 心 爪 目 冖 夂
瞿 : 目 隹
瞼 : 口 人 目 ㅅ 一
瞽 : 口 士 支 十 豆 丷 目 又 鼓
瞻 : 言 目 儿 厂 勹
矇 : 目 冖 ⺾ 豕
矍 : 又 目 隹
矗 : 十 目 ｜ 一
矚 : 虫 ⺲ 目 勹 尸
矜 : 矛 ㅅ マ 一
矣 : 矢 厶 乞
矮 : 禾 女 矢 乞
矼 : 口 工 石
砌 : 口 石 刀 匕
砒 : 口 石 比
礦 : 黄 口 石 田 ハ 广
砠 : 口 石 目
礪 : 口 石 田 厂 ⽱ ⺾
硅 : 口 石 土
碎 : 口 十 人 石 亠
硴 : ⺅ 口 石 匕 ⺾
碆 : 口 ⺡ 石 皮 又
硼 : 月 口 石
碚 : 口 石 立
碌 : ヨ 口 水 石 隶
碣 : 口 石 日 勹 匕 人 一 ｜
碵 : 貝 目 ハ 口 石 卜
碪 : 甘 口 石 儿 匚
碯 : 口 石 巛 囗
磑 : 口 山 石 豆 丷
磆 : 月 口 骨 石 冂 冖
磋 : 王 口 工 石 丷 羊
磔 : 口 石 舛 木 夕
碾 : 衣 口 石 二 尸
碼 : 口 石 馬 ⺣
磅 : 口 石 丷 方 立 亠 冖
磊 : 口 石
磬 : 口 士 石 殳 尸 几 又
磧 : 貝 目 ハ 口 石 土 二 亠
磚 : 口 十 寸 石 虫 田 亠 厶
磽 : 口 石 土 儿
磴 : 口 石 豆 丷 癶
礇 : 口 石 大 米 冂 釆
礒 : 王 口 石 丷 羊 亅 戈
礑 : 口 ⺌ 石 田 冖
礙 : 口 石 疋 矢 匕 マ 乞
礬 : 口 石 大 木 爻
礫 : 口 石 白 木 冫
祀 : ⺭ 已
祠 : 口 ⺭ 亅 一
祗 : 氏 ⺭ 一
祟 : ｜ 山 示 二 小
祚 : ｜ ノ ⺭
祕 : ノ 心 ⺭ 丶
祓 : ノ 一 ⺭ 丶
祺 : 甘 ハ ⺭
祿 : 水 ⺭ 隶 彑
禊 : 大 土 ⺭ 亠 刀 二
禝 : 田 ⺭ 儿 夂
禧 : 口 士 十 豆 丷 ⺭
齋 : 小 齊 元 刀 氏 廾
禪 : ｜ 一 口 田 日 ⺭
禮 : ｜ 一 口 豆 日 丷 ⺭
禳 : ｜ 衣 一 ハ ⺭ 亠 口
⽱ : ノ 虫 ⽱ 冂
禺 : 田 日 ⽱ 冂
秉 : ｜ ノ ヨ 一 禾 ハ
秕 : 禾 比
秧 : 禾 人 大 冂 冖
秬 : 禾 巨
秡 : ノ 一 禾 丶
秣 : ｜ 一 禾 ハ 木 亠
稈 : 禾 干 日
稍 : 禾 月 ⺌
稘 : 禾 甘 ハ
稙 : 禾 十 目
稠 : 禾 口 土 冂
稟 : 禾 口 亠 囗
禀 : 口 示 二 小 亠 囗
稱 : ｜ 一 禾 爪 冂 十
稻 : 臼 禾 爪
稾 : 禾 口 高 亠 冂
稷 : 禾 田 儿 夂
穃 : 禾 穴 口 ハ ㅅ 宀 谷
穗 : 禾 心 虫 日
穉 : 禾 牛 尸
穡 : 禾 口 人 土 囗
穢 : ノ 禾 止 小 戈
穩 : ヨ 禾 工 心 爪
龝 : 禾 亀 乙 勹 田
穰 : ｜ 衣 一 禾 口 亠
穹 : 弓 穴 儿 宀
穽 : ｜ ノ 穴 二 儿 宀 井
窈 : 穴 力 儿 宀 幺
窗 : 穴 儿 囗 宀 夕
窕 : 穴 儿 冫 宀
窘 : ノ ヨ 一 穴 口 儿 宀
窖 : ノ 穴 口 土 儿 宀
窩 : 穴 口 入 冂 宀
竈 : 穴 土 儿 宀 黽
窰 : 缶 穴 夕 儿 凵 宀
窶 : ｜ 一 穴 口 女 儿 宀
竅 : 穴 白 方 儿 宀 攵 乞
竄 : 臼 穴 鼠 儿 宀
窿 : 穴 生 儿 夂 宀 ⻖
邃 : 穴 ⻌ 丷 儿 宀 豕
竇 : 貝 目 ハ 穴 士 儿 冂 宀
竊 : 穴 釆 米 卜 儿 冂 厶 宀 ⽱
竍 : 十 立
竏 : ノ 十 立
竕 : 刀 丷 立
竓 : 毛 立
站 : 口 卜 立
竚 : 立 亅 宀
竝 : 立
竡 : 一 白 立
竢 : 矢 立 厶 乞
竦 : ｜ 口 丷 木 立
竭 : 日 立 勹 匕
竰 : 里 立 厂
笂 : 九 竹 丶 乞
笏 : ノ 竹 勹 勿 乞
笊 : 竹 爪 乞
笆 : 竹 巴 乞
笳 : 口 竹 力 乞
笘 : 口 竹 卜 乞
笙 : 生 竹 乞
笞 : 口 竹 厶 乞
笵 : ⺡ 竹 卩 乞
笨 : 一 竹 木 乞
笶 : 竹 矢 乞
筐 : 王 竹 匚 乞
筺 : 王 竹 匚 丶 乞
笄 : ｜ ノ 竹 二 廾 一 乞
筍 : 竹 日 勹 乞
笋 : ノ ヨ 竹 乞
筌 : 王 竹 ㅅ 乞
筅 : 竹 土 儿 乞
筵 : 止 竹 廴 ノ 乞
筥 : 口 竹 ノ 乞
筴 : 人 大 竹 乞
筧 : 見 竹 乞
筰 : ｜ ノ ⺅ 竹 乞
筱 : ⺅ 竹 攵 ｜ 乞
筬 : ノ 竹 戈 乞
筮 : 工 人 竹 乞
箝 : 甘 竹 心 乞
箘 : 禾 竹 囗 乞
箟 : 竹 日 比 乞
箍 : 巾 竹 匚 心 乞
箜 : 穴 工 竹 儿 宀 乞
箚 : ⺉ 口 竹 ㅅ 一 乞
箋 : 竹 戈 乞
箒 : ヨ 巾 竹 冖 乞
箏 : ヨ 竹 爪 亅 乞
筝 : ヨ 竹 亅 勹 乞
箙 : 月 竹 又 卩 乞
篋 : 人 大 竹 匚 乞
篁 : 王 竹 白 乞
篌 : ⺅ 竹 矢 ユ 乞
篏 : 甘 欠 竹 乞
箴 : ノ 口 竹 戈 乞
篆 : 彑 竹 豕 乞
篝 : ｜ 一 竹 二 冂 十 乞
篩 : 巾 口 竹 ｜ 乞
簑 : 衣 一 竹 亠 口 乞
簔 : 衣 一 竹 亠 口 乞
篦 : 竹 比 囗 乞
篥 : 西 竹 木 乞
籠 : 月 竹 立 乞
簀 : 貝 目 ハ 竹 土 二 亠 乞
簇 : 竹 方 矢 乞
簓 : 口 十 竹 冂 彡 乞
篳 : ｜ 一 竹 田 日 乞
篷 : ⻌ 竹 夂 乞
簗 : ⺡ 竹 刀 木 丶 乞
簍 : ｜ 一 口 女 竹 乞
篶 : 一 止 竹 鳥 ⺣ 乞
簣 : ｜ 一 貝 目 ハ 口 竹 乞
簧 : 黄 竹 田 ハ 乞
簪 : 竹 日 无 乞
簟 : 十 西 竹 日 曰 乞
簷 : 言 竹 儿 厂 乞
簫 : ｜ ノ ヨ 水 竹 隶 聿 乞
簽 : 口 人 竹 ㅅ 一 乞
籌 : 口 工 士 寸 竹 乞
籃 : 皿 臣 竹 二 乞
籔 : 女 竹 米 攵 乞
籏 : 甘 竹 ハ 方 乞
籀 : 竹 田 刀 厶 心 乞
籐 : 月 人 水 大 竹 二 丷 乞
籘 : 月 糸 幺 小 人 大 竹 二 丷 乞
籟 : ｜ 貝 目 口 竹 ハ 頁 木 乞
籤 : 竹 戈 韭 人 乞
籖 : 竹 土 戈 韭 乞
籥 : ｜ 一 口 竹 ㅅ 冊 龠 廾 乞
籬 : 竹 亠 凵 ⽱ 隹 乞
籵 : 十 米
粃 : 比 米
粐 : 戸 米 一 尸
粤 : 一 米 囗 勹 釆
粭 : 口 米 ㅅ 一
粢 : 欠 米 冫
粫 : 而 米
粡 : 口 米 冂 一
粨 : 米 一 白
粳 : ノ 米 一 田
粲 : 米 卜 又 夕
粱 : ⺡ 刀 丷 米
粮 : 艮 米
粹 : 十 人 米 亠
粽 : 示 二 小 米 宀
糀 : ⺅ 米 匕 ⺾
糅 : 米 矛 木 マ
糂 : 甘 米 儿 匚
糘 : 米 宀 豕
糒 : 米 用 厂 ⺾
糜 : 米 木 广 麻
糢 : 大 日 米 ⺾
鬻 : 一 弓 口 米 儿 冂 鬲
糯 : 雨 而 米
糲 : 田 米 厂 ⽱ ⺾
糴 : ヨ 入 米 隹
糶 : ｜ ヨ 山 米 隹
糺 : 乙 糸 幺 小
紆 : 糸 幺 小 二 亅
紂 : 糸 幺 小 寸
紜 : 糸 幺 小 二 厶
紕 : 糸 幺 小 比
紊 : 糸 幺 小 文
絅 : 口 糸 幺 小 冂
絋 : 糸 幺 小 厶 广
紮 : 乙 糸 幺 小 木
紲 : 糸 幺 小 世
紿 : 口 糸 幺 小 厶
紵 : 糸 幺 小 亅 宀
絆 : ｜ 糸 幺 小 二 丷 十
絳 : 糸 幺 小 二 夂
絖 : 糸 幺 小 ⺌ 儿
絎 : 行 糸 幺 小 彳
絲 : 糸 幺 小
絨 : ノ 一 糸 幺 小 戈
絮 : 口 糸 幺 小 女
絏 : ノ 糸 幺 小 日
絣 : ｜ ノ 糸 幺 小 二 丷 廾 一
經 : 工 糸 幺 小 巛
綉 : 乃 禾 糸 幺 小 ノ
絛 : ⺅ 糸 幺 小 夂 攵 乞 ｜
綏 : 糸 幺 小 女 爪
絽 : 口 糸 幺 小 ノ
綛 : 丶 糸 幺 小 心 刀
綺 : 口 糸 幺 小 大 亅 一
綮 : 戸 糸 幺 小 攵 一 尸 乞
綣 : 糸 幺 小 人 大 二 丷 已
綵 : 糸 幺 小 爪 木
緇 : 糸 幺 小 巛 田
綽 : 糸 幺 小 十 日 卜
綫 : 糸 幺 小 戈
總 : 糸 幺 小 心 囗 夂
綢 : 口 糸 幺 小 土 冂
綯 : 缶 糸 幺 小 凵 勹
緜 : ノ 巾 糸 幺 小 白
綸 : ｜ 一 糸 幺 小 ㅅ 冊 廾
綟 : 戸 糸 幺 小 大 一 尸
綰 : ｜ 口 糸 幺 小 宀
緘 : ノ 口 糸 幺 小 戈
緝 : 口 糸 幺 小 耳
緤 : 糸 幺 小 木 世
緞 : ｜ 糸 幺 小 殳 几 又
緻 : 糸 幺 小 至 土 厶 攵 一 乞
緲 : ノ 糸 幺 小 目
緡 : 口 氏 糸 幺 小 日 尸
縅 : ノ 糸 幺 小 女 戈
縊 : 皿 糸 幺 小 丷
縣 : 糸 幺 小 目 一 ｜
縡 : 糸 幺 小 十 辛 立 宀
縒 : 王 工 糸 幺 小 丷 羊
縱 : ⺅ 糸 幺 小 人 走 土 彳
縟 : 糸 幺 小 寸 辰 衣
縉 : 一 糸 幺 小 二 日 厶
縋 : ｜ 口 ⻌ 糸 幺 小
縢 : 月 糸 幺 小 人 大 二 丷
繆 : 羽 糸 幺 小 ㅅ 冫 彡
繦 : 弓 糸 幺 小 虫 厶
縻 : 糸 幺 小 木 广 麻
縵 : 糸 幺 小 日 ⺲ 又
縹 : 糸 幺 小 示 二 西
繃 : 月 山 糸 幺 小
縷 : ｜ 一 口 糸 幺 小 女
縲 : 糸 幺 小 田
縺 : ⻌ 糸 幺 小 車
繧 : 雨 糸 幺 小 二 厶
繝 : 糸 幺 小 日 門
繖 : ｜ 一 月 糸 幺 小 二 攵 乞
繞 : 糸 幺 小 土 儿
繙 : 糸 幺 小 田 釆 米
繚 : 糸 幺 小 大 日 丷 亠
繹 : 糸 幺 小 十 辛 土 ⺲ 立 亠
繪 : 糸 幺 小 日 ⺲ ㅅ 一
繩 : 糸 幺 小 黽
繼 : ｜ 糸 幺 小 匚
繻 : 雨 糸 幺 小 而
纃 : 糸 幺 小 齊 刀 氏 廾
緕 : 糸 幺 小 斉 文
繽 : ノ 貝 目 ハ 糸 幺 小 宀
辮 : 糸 幺 小 十 辛 立
繿 : 皿 糸 幺 小 臣 二 乞
纈 : 貝 目 ハ 口 士 糸 幺 小 頁
纉 : 貝 目 ハ 糸 幺 小 人 大 二 亠
續 : 貝 目 ハ 士 糸 幺 小 儿 囗
纒 : 黒 糸 幺 小 土 里 厂 ⺣
纐 : 貝 目 ハ 糸 幺 小 父 頁 亠
纓 : 貝 目 ハ 糸 幺 小 女
纔 : 糸 幺 小 比 儿 勹
纖 : 糸 幺 小 人 戈 韭
纎 : 糸 幺 小 土 戈 韭
纛 : 糸 幺 小 土 二 母 目 亠 毋
纜 : 見 糸 幺 小 臣 二 乞
缸 : 缶 工 凵
缺 : ノ 缶 人 大 二 凵 ユ
罅 : 缶 二 丷 卜 亅 凵 匕 厂 虍
罌 : 貝 目 ハ 缶 凵
罍 : 缶 田 凵
罎 : 雨 缶 二 日 凵 厶
罐 : 缶 口 凵 ⺾ 隹
网 : ノ 丶 冂
罕 : 干 儿 冖
罔 : 亡 一 丷 冂 亠
罘 : ｜ ノ 一 ⺲ 丶
罟 : 口 士 ⺲
罠 : 口 氏 ⺲ 尸
罨 : 乙 大 日 ⺲ 奄
罩 : 十 日 ⺲ 卜
罧 : ⺲ 木
罸 : 言 寸 ⺲
羂 : 月 口 糸 幺 小 ⺲
羆 : 月 ⺲ 厶 匕 ⺣
羃 : 巾 大 日 ⺲ ⺾
羈 : 革 馬 ⺲ ⺣
羇 : 革 口 大 ⺲ 亅 凵
羌 : 王 丷 羊 儿
羔 : 王 丷 羊 ⺣
羞 : ノ ヨ 王 丷 羊
羝 : 王 氏 丷 羊
羚 : 王 丷 羊 ㅅ 卩 一
羣 : ノ ヨ 王 口 丷 羊
羯 : 王 日 丷 羊 勹 匕
羲 : 王 禾 丷 羊 戈
羹 : 王 大 丷 羊 ⺣
羮 : 王 人 大 丷 羊 ⺣ 二
羶 : 王 口 日 丷 羊 亠 囗 一
羸 : 王 亡 月 口 丷 羊 丶 几
譱 : 王 言 丷 羊
翅 : 羽 支 冫 又 十
翆 : 羽 九 十 冫
翊 : 羽 立 冫
翕 : 羽 口 ㅅ 冫 一
翔 : 羽 丷 羊 冫
翡 : 羽 非 冫
翦 : 一 羽 ⺉ 月 丷 冫
翩 : ｜ 一 羽 戸 冊 冫 尸 廾
翳 : 羽 矢 冫 匚 殳 几 又 乞
翹 : 羽 土 儿 冫
飜 : 田 釆 飛 米
耆 : 日 ⺹ 匕
耄 : 毛 ⺹ 匕
耋 : 至 土 ⺹ 厶 匕
耒 : ｜ 木 耒 ノ ハ
耘 : ｜ 二 ハ 木 厶 耒 ノ
耙 : ｜ ハ 木 巴 耒 ノ
耜 : ｜ 口 木 耒 ノ ハ
耡 : ｜ ハ 木 目 力 耒 ノ
耨 : ｜ 寸 辰 ハ 木 耒 ノ 衣
耿 : 火 耳
耻 : 止 耳
聊 : 耳 卩
聆 : 耳 ㅅ 卩 一
聒 : 口 耳 舌
聘 : ｜ 耳 日 一 勹
聚 : 耳 又 冫
聟 : 口 耳 矢 乞
聢 : 耳 疋 宀
聨 : 耳 幺 廾
聳 : 耳 丷 疋 彳 人
聲 : 士 耳 尸 殳 几 又
聰 : 耳 心 囗 夂
聶 : 耳
聹 : 耳 心 ⺲ 亅 宀 皿
聽 : 王 耳 十 心 ⺲
聿 : 聿
肄 : 矢 匕 聿 乞
肆 : 長 厶 聿
肅 : ヨ 片 爿 聿
肛 : 工 月
肓 : 亡 月 亠
肚 : 土 月
肭 : 人 月 冂
冐 : 月 二 冂
肬 : 月 丶 尤 尢
胛 : ｜ 月 日 田
胥 : 月 疋
胙 : ｜ ノ 月
胝 : 月 氏
胄 : ｜ 月 日 田
胚 : ｜ ノ 一 月 丶
胖 : ｜ 二 月 丷 十
脉 : 月 水 丶
胯 : 月 大 二 勹
胱 : 月 ⺌ 儿
脛 : 月 工 巛
脩 : ⺅ 月 攵 乞 ｜
脣 : 月 辰 衣
脯 : ｜ 十 月 用 丶
腋 : ⺅ 月 夕 亠
隋 : ノ 一 月 工 ⻖
腆 : ｜ 一 月 日 ハ 冂
脾 : 月 十 田 ノ
腓 : 月 非
腑 : ⺅ 月 寸 广
胼 : ｜ ノ 月 二 丷 廾 一
腱 : 月 廴 聿
腮 : 月 心 田
腥 : 月 生 日
腦 : 巛 月 囗
腴 : 月 人 日 臼
膃 : 月 皿 日
膈 : 口 月 儿 冂 鬲
膊 : 十 寸 田 月 日 丶
膀 : 月 丷 方 立 亠 冖
膂 : 衣 月 方 亠 乞
膠 : 羽 月 ㅅ 冫 彡
膕 : 口 月 囗 戈
膤 : ヨ 雨 月
膣 : 穴 至 土 月 儿 厶 宀
腟 : 至 土 月 厶 宀
膓 : ノ 月 日 勿 一 乞
膩 : 貝 目 ハ 二 月 弋
膰 : 田 月 釆 米
膵 : 十 人 月 亠 ⺾
膾 : 月 日 ⺲ ㅅ 一
膸 : ノ 一 月 工 ⻌
膽 : 言 月 儿 厂 勹
臀 : 月 ハ 尸 殳 几 又
臂 : 月 口 十 辛 立 尸
膺 : ⺅ 月 广 隹
臉 : 口 人 月 ㅅ 一
臍 : 月 齊 刀 氏 廾
臑 : 雨 而 月
臙 : 口 月 凵 匕 ⺣ 爿
臘 : 臼 巛 鼠 月 囗
臈 : 月 日 勹 匕 ⺾
臚 : 皿 田 月 卜 匕 厂 虍
臟 : ノ 臣 月 戈 ⺾
臠 : 言 糸 幺 小 肉
臧 : ノ 臣 冫 戈 ⽧
臺 : 口 士 至 土 冖 厶
臻 : ノ 禾 至 大 土 二 厶
臾 : 臼 人
舁 : 臼 廾
舂 : ノ 臼 大 二
舅 : 臼 田 力
與 : 一 臼 ハ
舊 : 臼 ⺾ 隹
舍 : 口 舌 ㅅ
舐 : 口 氏 舌
舖 : 口 十 舌 用 ㅅ 丶
舩 : 舟 ハ 厶
舫 : 舟 方
舸 : 口 舟 亅
舳 : ｜ 舟 日 田
艀 : 子 舟 爪
艙 : 口 舟 ㅅ 尸 一
艘 : 支 舟 日 又
艝 : ヨ 雨 舟
艚 : ｜ 一 舟 日
艟 : 舟 里 立
艤 : 王 舟 丷 羊 亅 戈
艢 : 口 舟 人 土 囗
艨 : 舟 冖 ⺾ 豕
艪 : 魚 舟 田 日 ⺣
艫 : 皿 舟 田 卜 匕 厂 虍
舮 : 戸 舟 一 尸
艱 : 艮 人 大 二 ⺾
艷 : 口 山 色 豆 丷 凵
艸 : ⺾ 屮
⺾ : ノ ⺾
芍 : 丶 勹 ⺾
芒 : 亡 ⺾ 亠
芫 : 二 儿 ⺾ 元
芟 : 殳 ⺾ 几 又
芻 : 勹 屮 ⺾
芬 : 刀 ハ ⺾
苡 : ｜ 人 ⺾
苣 : 巨 ⺾
苟 : 口 勹 ⺾
苒 : ｜ 一 冂 ⺾ 十
苴 : 一 目 ⺾
苳 : 丶 夂 ⺾
苺 : 母 ⺾ 毋
莓 : 一 母 ⺾ 毋 乞
范 : ⺡ 卩 ⺾
苻 : ⺅ 寸 ⺾
苹 : 干 ハ ⺾
苞 : 勹 已 ⺾
茆 : ノ 卩 ⺾
苜 : 目 ⺾
茉 : ｜ 一 ハ 木 亠 ⺾
苙 : 立 ⺾
茵 : 大 囗 ⺾
茴 : 口 囗 ⺾
茖 : 口 夂 ⺾
茲 : 幺 ⺾
茱 : ｜ ノ 牛 二 ハ 木 亠 ⺾
荀 : 日 勹 ⺾
茹 : 口 女 ⺾
荐 : ノ 一 子 ⺾
荅 : 口 ㅅ ⺾ 一
茯 : ⺅ 犬 ⺾
茫 : 亡 ⺡ ⺾
茗 : 口 夕 ⺾
茘 : 刀 ⺾
莅 : ⺅ 立 ⺾
莚 : ノ 止 廴 ⺾
莪 : 亅 戈 ⺾
莟 : 口 ㅅ ⺾ 一
莢 : 人 大 ⺾
莖 : 一 工 巛 ⺾
茣 : 一 口 ハ ⺾
莎 : ノ ⺡ 小 ⺾
莇 : 目 力 ⺾
莊 : 士 爿 ⺾
荼 : 小 二 ハ ㅅ 亅 ⺾ 一
莵 : 鬼 儿 匕 ⺾
荳 : 口 豆 丷 ⺾
荵 : 心 刀 丶 ⺾
莠 : ノ 禾 ⺾
莉 : 禾 ⺉ ⺾
莨 : 艮 ⺾
菴 : 乙 大 日 ⺾ 奄
萓 : 一 目 宀 ⺾
菫 : ｜ 一 口 土 二 ⺾
菎 : 日 比 ⺾
菽 : 小 卜 又 ⺾
萃 : 十 人 亠 ⺾
菘 : ハ 木 厶 ⺾
萋 : ｜ ヨ 女 ⺾
菁 : 月 青 土 二 亠 ⺾
菷 : ヨ 巾 冖 ⺾
萇 : 長 ⺾
菠 : ⺡ 皮 又 ⺾
菲 : 非 ⺾
萍 : 干 ⺡ 丷 ⺾
萢 : ⺡ 勹 已 ⺾
萠 : 月 ⺾
莽 : 大 廾 ⺾
萸 : 人 日 ⺾ 臼
蔆 : ⺡ 土 儿 夂 ⺾
菻 : 木 ⺾
葭 : ｜ 又 ⺾
萪 : 禾 斗 ⺾
萼 : 口 二 ⺾ 勹
蕚 : 口 二 ⺾ 勹 品
蒄 : 寸 二 儿 冖 ⺾ 元
葷 : 車 冖 ⺾
葫 : 月 口 十 ⺾
蒭 : 勹 屮 ⺾
葮 : ｜ 殳 ⺾ 几 又
蒂 : 巾 丷 立 亠 冖 ⺾
葩 : 白 巴 ⺾
葆 : ⺅ 口 木 ⺾
萬 : 田 日 冂 ⽱ ⺾
葯 : 糸 幺 小 丶 勹 ⺾
葹 : 也 方 匕 ⺾ 乞
萵 : 口 冂 ⺾
蓊 : 羽 ハ 冫 厶 ⺾
葢 : 皿 大 丶 ⺾
蒹 : ｜ ヨ 一 丷 ⺾
蒿 : 口 高 亠 冂 ⺾
蒟 : 口 立 勹 ⺾
蓙 : 人 土 广 ⺾
蓍 : 日 ⺹ ⺾ 匕
蒻 : 弓 冫 ⺾
蓚 : ⺅ 彡 攵 ⺾ 乞 ｜
蓐 : 寸 辰 ⺾ 衣
蓁 : 禾 大 二 ⺾
蓆 : 一 巾 凵 广 ⺾
蓖 : 比 囗 ⺾ 丶 ノ
蒡 : 丷 方 立 亠 冖 ⺾
蔡 : 示 二 小 癶 ⺾
蓿 : ⺅ 白 宀 ⺾
蓴 : 一 寸 虫 日 ⺾ 十 田
蔗 : 一 凵 广 ⺣ ⺾
蔘 : 大 厶 彡 ⺾
蔬 : 止 川 亠 厶 ⺾ 疋
蔟 : 方 矢 ⺾ 乞
蔕 : 一 巾 儿 冖 凵 ⺾
蔔 : 口 田 勹 ⺾
蓼 : 羽 ㅅ 冫 彡 ⺾
蕀 : ｜ ハ 木 冂 ⺾
蕣 : 舛 爪 夕 冖 ⺾
蕘 : 一 土 儿 ⺾
蕈 : 十 西 日 曰 ⺾
蕁 : ヨ 口 工 寸 ⺾
蘂 : 心 木 ⺾
蕋 : 止 ⺾
蕕 : 酉 丷 ⺨ ⺾
薀 : 皿 ⺡ 口 人 ⺾
薤 : 歹 ⺾ 韭
薈 : 日 ⺲ ㅅ ⺾ 一
薑 : 一 田 二 ⺾
薊 : ⺉ 魚 田 ⺣ ⺾
薨 : ⺲ 夕 冖 匕 ⺾
蕭 : ｜ ノ ヨ 米 ⺾ 聿
薔 : 口 人 土 囗 ⺾
薛 : ｜ 口 十 辛 立 ⺾
藪 : ｜ 一 口 女 攵 ⺾ 乞
薇 : 山 几 彳 攵 ⺾ 乞
薜 : 口 十 辛 立 尸 ⺾
蕷 : 貝 目 ハ 頁 矛 亅 ⺾
蕾 : 雨 田 ⺾
薐 : 禾 土 儿 夂 ⺾
藉 : ｜ 一 二 日 ハ 木 耒 ⺾ ノ
薺 : 亠 ⺾ 齊 刀 氏 廾
藏 : ノ 臣 戈 爿 ⺾
薹 : 口 士 至 土 冖 厶 ⺾
藐 : 日 儿 ⺾ 豸
藕 : ｜ 田 日 ハ 木 ⽱ 耒 ⺾ ノ
藝 : 九 土 二 丶 儿 厶 ⺾
藥 : 白 木 幺 ⺾
藜 : 禾 水 ㅅ 勹 ⺾ 黍
藹 : 言 日 勹 匕 ⺾
蘊 : 皿 糸 幺 小 日 ⺾
蘓 : 禾 魚 田 ⺣ ⺾
蘋 : ノ 貝 目 ハ 止 小 頁 ⺾
藾 : ｜ 貝 目 口 ハ 頁 木 ⺾
藺 : 門 ⺾ 隹
蘆 : 皿 田 卜 匕 厂 ⺾ 虍
蘢 : 月 立 ⺾
蘚 : 王 魚 田 丷 羊 ⺣ ⺾
蘰 : 糸 幺 小 日 ⺲ 又 ⺾
蘿 : 糸 幺 小 ⺲ ⺾ 隹
虍 : 卜 匕 厂 虍
乕 : ｜ ノ 一 巾 厂
虔 : 文 卜 匕 厂 虍
號 : 口 卜 儿 匕 厂 虍 一 勹
虧 : 二 卜 匕 厂 虍 隹 勹
虱 : ノ 一 乙 虫
蚓 : ｜ 弓 虫
蚣 : 虫 ハ 厶
蚩 : 一 山 虫 屮
蚪 : 虫 斗
蚋 : 人 虫 冂
蚌 : ｜ 一 虫 二
蚶 : 甘 虫
蚯 : 斤 虫 一
蛄 : 口 十 虫
蛆 : 虫 目
蚰 : ｜ 虫 日 田
蛉 : 虫 ㅅ 卩 一
蠣 : 虫 田 厂 ⽱ ⺾
蚫 : 虫 勹 已
蛔 : 口 虫 囗
蛞 : 口 舌 虫
蛩 : 工 虫 丶 几
蛬 : ｜ 一 虫 二 ハ
蛟 : 虫 父 亠
蛛 : ｜ ノ 牛 虫 二 ハ 木
蛯 : 虫 ⺹ 匕
蜒 : ノ 止 虫 廴
蜆 : 見 虫
蜈 : 口 虫 ハ
蜀 : 虫 ⺲ 勹
蜃 : 辰 虫 衣
蛻 : 口 虫 丷 儿
蜑 : ノ 止 虫 廴
蜉 : 子 虫 爪
蜍 : 小 虫 二 ㅅ 亅 一
蛹 : 虫 用 マ
蜊 : 禾 ⺉ 虫
蜴 : ノ 虫 日 勿 勹
蜿 : 虫 夕 卩 宀
蜷 : 人 大 虫 二 丷 已
蜻 : 月 青 虫 土 二 亠
蜥 : 斤 虫 木
蜩 : 口 虫 土 冂
蜚 : 虫 非
蝠 : 口 虫 田
蝟 : 月 虫 田
蝸 : 口 虫 冂
蝌 : 禾 虫 斗
蝎 : 虫 日 勹 匕
蝴 : 月 口 十 虫
蝗 : 王 虫 白
蝨 : ノ 一 乙 虫
蝮 : 虫 日 夂 乞
蝙 : ｜ 一 戸 虫 冊 尸 廾
蝓 : ⺉ 月 虫 ㅅ 一
蝣 : 子 虫 方 乞
蝪 : ノ 虫 日 勿 一 勹
蠅 : 虫 黽
螢 : 火 虫 冖
螟 : 虫 日 ハ 亠 冖
螂 : 艮 虫 ⻏
螯 : 虫 土 方 攵 乞
蟋 : 心 虫 釆 米
螽 : 虫 丶 夂
蟀 : 十 虫 亠 冫 幺 玄
蟐 : 巾 口 ⺌ 虫 冖
雖 : 口 虫 隹
螫 : 赤 虫 土 攵 乞
蟄 : 九 十 辛 虫 立 丶 亠
螳 : 口 ⺌ 虫 土 冖
蟇 : 大 虫 日 ⺾
蟆 : 大 虫 日 ⺾
螻 : ｜ 一 口 女 虫
蟯 : 虫 土 儿
蟲 : 虫
蟠 : 虫 田 釆 米
蠏 : 角 牛 虫 刀
蠍 : 欠 虫 日 勹 匕
蟾 : 言 虫 儿 厂
蟶 : 王 口 耳 虫
蟷 : 口 ⺌ 虫 田 冖
蠎 : 十 大 虫 廾 ⺾
蟒 : 大 虫 廾 ⺾
蠑 : 火 虫 木 冖
蠖 : 虫 又 ⺾ 隹
蠕 : 雨 而 虫
蠢 : 大 虫 二 日
蠡 : 彑 虫 豕
蠱 : 皿 虫
蠶 : 虫 日 无
蠹 : ｜ 一 口 石 虫 冖
蠧 : 口 士 石 虫 冖
蠻 : 言 糸 幺 小 虫
衄 : ｜ 一 血 皿
衂 : 血 皿 刀 丶
衒 : 行 亠 幺 彳 玄
衙 : 一 口 行 彳 五 ｜
衞 : 巾 口 行 彳
衢 : 行 目 彳 隹
衫 : ⻂ 彡
袁 : 衣 口 土
衾 : 衣 ㅅ 亠 一
袞 : 衣 口 ハ 亠
衵 : ⻂ 日
衽 : 王 ⻂ 士
袵 : 王 ⺅ ⻂
衲 : ⻂ 人 冂
袂 : ⻂ 人 大 二 ユ
袗 : ⻂ ㅅ 彡
袒 : ⻂ 日 一
袮 : ノ ⻂ 小 乞
袙 : ⻂ 白
袢 : ｜ ⻂ 二 丷 十
袍 : ⻂ 勹 已
袤 : 衣 矛 亠
袰 : 衣 母 毋 亠
袿 : ⻂ 土
袱 : ⺅ 犬 ⻂
裃 : ⻂ 卜
裄 : 行 ⻂ 彳
裔 : 衣 口 儿 冂 亠
裘 : 衣 水 丶 亠
裙 : ノ ヨ 口 ⻂ 尸
裝 : 衣 士 爿 亠
裹 : 衣 田 ハ 亠 木
褂 : ⻂ 土 卜
裼 : ノ ⻂ 日 勿 勹
裴 : 衣 非 亠
裨 : 十 ⻂ 田
裲 : ｜ 一 ⻂ 入 冂
褄 : ｜ ヨ 一 ⻂ 女
褌 : 車 ⻂ 冖
褊 : ｜ 一 戸 ⻂ 冊 尸 廾
褓 : ⺅ 口 ⻂ 木
襃 : 衣 口 木 亠
褞 : 皿 ⻂ 日
褥 : ⻂ 寸 辰 衣
褪 : ⻌ 艮 ⻂
褫 : ⻂ 卜 儿 匕 厂 虍
襁 : 弓 ⻂ 虫 厶
襄 : ｜ 衣 一 ハ 亠 井
褻 : 衣 九 土 丶 亠
褶 : 羽 ⻂ 白 冫
褸 : ｜ 一 口 ⻂ 女
襌 : 口 十 ⻂ 田
褝 : 十 ⻂ ⺌ 田
襠 : 口 ⻂ ⺌ 田 冖
襞 : 衣 口 十 辛 立 尸 亠
襦 : 雨 而 ⻂
襤 : 皿 ⻂ 臣 二 乞
襭 : 貝 目 ハ 口 ⻂ 土 頁
襪 : ノ ⻂ ⺲ 戈 ⺾
襯 : 見 ⻂ 木 立
襴 : ⻂ 日 木 門
襷 : 手 ⻂ ⺌ 丷
襾 : 西
覃 : 十 西 日
覈 : 西 白 方 攵 乞
覊 : 革 西 馬 ⺣
覓 : 見 爪
覘 : 見 口 卜
覡 : 見 工 人
覩 : 見 日 ⺹ 十
覦 : ⺉ 月 見 ㅅ 一
覬 : 見 口 山 豆 丷
覯 : ｜ 一 見 冂
覲 : 見 土 ⺾ 口 二
覺 : 臼 見 冖 爻
覽 : 見 臣 ⺲ 乞
覿 : 貝 目 ハ 見 士 儿 囗
觀 : 見 口 十 ⺾ 隹
觚 : 瓜 角
觜 : 角 止 匕
觝 : 角 氏
觧 : 王 角 丷 羊
觴 : ノ 角 日 勿 一 勹 乞
觸 : 角 虫 ⺲ 勹
訃 : 言 卜
訖 : 乙 言 乞
訐 : 干 言
訌 : 言 工
訛 : ⺅ 言 匕
訝 : 牙 言
訥 : 言 人 冂
訶 : 言 口 亅 一
詁 : 言 口 十
詛 : 言 目
詒 : 言 口 厶
詆 : 言 氏
詈 : 言 ⺲
詼 : 火 言 厂
詭 : 言 卩 厂 勹
詬 : 言 口 厂
詢 : 言 日 勹
誅 : ｜ ノ 牛 言 二 ハ 木
誂 : 言 儿 冫
誄 : ｜ 言 木 耒 ハ ノ
誨 : 言 母 毋 乞
誡 : 言 廾 戈
誑 : 王 言 ⺨
誥 : ノ 言 口 土
誦 : 言 用
誚 : 月 言 ⺌
誣 : 言 工 人
諄 : 言 子 亠 口
諍 : ヨ 言 爪 亅
諂 : 臼 言
諚 : 言 疋 宀
諫 : ｜ 言 口 ⺲ ハ 木
諳 : 音 言 日 立
諧 : 言 白 比
諤 : 言 口 二 勹
諱 : 言 口 韋
謔 : 言 卜 匕 匚 厂 虍
諠 : 言 二 日 宀 一
諢 : 言 車 冖
諷 : 言 虫 風 几
諞 : ｜ 一 言 戸 冊 尸 廾
諛 : 言 人 日 臼
謌 : 言 口 亅 一
謇 : ｜ 一 言 ハ 宀
謚 : 言 皿 丷
諡 : 言 皿 ハ 一 勹
謖 : 言 田 儿 夂
謐 : ノ 言 皿 心 丶
謗 : 言 丷 方 立 亠 冖
謠 : 缶 言 夕 凵
謳 : 言 口 匚 品
鞫 : 革 言 勹
謦 : 言 士 尸 殳 几 又
謫 : 言 口 十 丷 立 亠 冂 啇
謾 : 言 日 ⺲ 又
謨 : 言 大 日 ⺾
譁 : ｜ 一 言 ⺾
譌 : ノ 言 爪 ⺣
譏 : 言 丶 幺 戈 ノ
譎 : 言 口 矛 儿 冂
證 : 言 口 豆 丷 癶
譖 : 言 日 无
譛 : 言 人 大 二 日
譚 : 言 十 西 日 曰
譫 : 言 儿 厂 勹
譟 : 言 口 木 品
譬 : 言 口 十 辛 立 尸
譯 : 言 十 辛 土 ⺲ 立 亠
譴 : ｜ 一 言 口 ⻌
譽 : 臼 言 ハ
讀 : 貝 目 ハ 言 士 儿 囗
讌 : 一 言 口 凵 匕 ⺣ 爿
讎 : 言 隹
讒 : 言 口 比 儿 勹
讓 : ｜ 衣 一 言 口 亠
讖 : 言 人 戈 韭
讙 : 言 口 十 ⺾ 隹
讚 : ノ 言 土 儿 貝 目 ハ
谺 : 牙 口 谷 ハ ㅅ
豁 : 口 谷 土 ハ ㅅ 亠 宀 二
谿 : 口 大 谷 爪 丷 ㅅ 幺
豈 : 口 山 豆 丷
豌 : 口 豆 丷 夕 卩 宀
豎 : 口 臣 豆 丷 又
豐 : 口 山 豆 丷 凵
豕 : 豕
豢 : 人 大 二 丷 豕
豬 : 日 ⺹ 豕
豸 : 豸
豺 : ノ 一 亅 豸
貂 : 口 刀 豸
貉 : 口 夂 豸
貅 : ⺅ 木 豸
貊 : 白 豸
貍 : 里 豸
貎 : 臼 儿 豸
貔 : 比 囗 豸
豼 : 比 豸
貘 : 大 日 ⺾ 豸
戝 : 貝 目 ハ 戈
貭 : 貝 目 ハ 十 厂
貪 : 貝 目 ハ ㅅ 一
貽 : 貝 目 ハ 口 厶
貲 : 貝 目 ハ 止 匕
貳 : 貝 目 ハ 二 弋
貮 : 貝 目 ハ 弋
貶 : ノ 乙 貝 目 ハ 亠
賈 : 貝 目 ハ 西
賁 : 貝 目 ハ 十 ⺾
賤 : 貝 目 ハ 戈
賣 : 貝 目 ハ 士 ⺲
賚 : 一 貝 目 人 ハ 木
賽 : ｜ 一 貝 目 ハ 宀
賺 : ｜ ヨ 貝 目 ハ
賻 : 貝 目 ハ 十 寸 田 丶
贄 : 九 貝 目 ハ 十 辛 立 丶 亠
贅 : 貝 目 ハ 土 方 攵 乞
贊 : ノ 貝 目 ハ 土 儿
贇 : 貝 目 ハ 止 文 戈
贏 : 亡 貝 目 ハ 月 口
贍 : 貝 目 ハ 言 儿 厂
贐 : ｜ ヨ 貝 目 ハ 皿 ⺣
齎 : 貝 目 ハ 亠 齊 刀 氏 廾
贓 : ノ 貝 目 ハ 臣 冫 戈 ⽧
賍 : 貝 目 ハ 土 广
贔 : 貝 目 ハ
贖 : 貝 目 ハ 士 儿 囗
赧 : ｜ 口 赤 土 又
赭 : 赤 土 日 ⺹
赱 : 走 土
赳 : ｜ 走 土
趁 : 走 土 ㅅ 彡
趙 : 月 ⺌ 走 土
跂 : 口 支 足 又 十 止
趾 : 口 止 足
趺 : 口 人 足 二 大 止
跏 : 口 足 力 止
跚 : ｜ 一 口 足 冊 冂 止 廾
跖 : 口 石 足 止
跌 : ノ 口 人 足 大 土 二 止
跛 : 口 足 皮 又 止
跋 : ノ 一 口 足 丶 止
跪 : 口 足 卩 厂 勹 止
跫 : 口 工 足 丶 几 止
跟 : 口 艮 足 止
跣 : ノ 口 足 土 儿 止
跼 : 口 足 尸 止
踈 : ｜ 口 足 ハ 木 止
踉 : 口 艮 足 止
跿 : 口 走 足 土 止
踝 : 口 足 田 木 止
踞 : 口 十 足 尸 止
踐 : 口 足 戈 止
踟 : 口 足 矢 止 乞
蹂 : 口 足 矛 木 マ 止
踵 : ｜ ノ 口 足 日 里 止
踰 : ⺉ 月 口 足 ㅅ 止 一
踴 : 口 足 田 力 マ 止
蹊 : 口 足 大 爪 幺 止
蹇 : ｜ 一 口 足 ハ 宀 止
蹉 : 王 口 工 足 丷 羊 止
蹌 : 口 足 ㅅ 尸 止 一
蹐 : 月 口 人 足 止 二
蹈 : 臼 口 足 爪 止
蹙 : ノ 口 小 足 卜 戈 止
蹤 : 口 足 丷 疋 彳 止
蹠 : 一 口 足 凵 广 ⺣ 止
踪 : 口 示 二 小 足 宀 止
蹣 : 一 口 足 入 冂 凵 止
蹕 : ｜ 一 口 足 田 止
蹶 : 欠 口 足 丷 厂 屮 止
蹲 : 口 寸 足 酉 丷 止
蹼 : 王 口 人 足 丷 羊 止 二 大
躁 : 口 足 木 品 止
躇 : 口 足 日 ⺹ ⺾ 止
躅 : 口 足 虫 ⺲ 勹 止
躄 : 口 十 辛 足 立 尸 止
躋 : 口 足 亠 齊 刀 氏 廾 止
躊 : 口 工 士 寸 足 止
躓 : 貝 目 ハ 斤 口 足 止
躑 : 口 足 大 酉 丷 ⻏ 止
躔 : 口 足 田 土 儿 广 止 里
躙 : 口 足 門 隹 止
躪 : 口 足 門 ⺾ 隹 止
躡 : 口 耳 足 止
躬 : 弓 身
躰 : ｜ 身 木
軆 : ｜ 一 口 身 豆 日 丷
躱 : ノ 身 木 乃
躾 : 王 身 大 丷 羊
軅 : ⺅ 身 厂 隹
軈 : ⺅ 心 身 广 隹
軋 : 乙 車
軛 : 車 卩 厂
軣 : 車 冫
軼 : ノ 車 人 大 土 二
軻 : 口 車 亅
軫 : 車 ㅅ 彡
軾 : 工 車 戈 弋
輊 : 至 車 土 厶 一
輅 : 口 車 夂
輕 : 工 車 巛
輒 : 乙 耳 車
輙 : 耳 車 又
輓 : 車 免 儿 勹
輜 : 車 巛 田
輟 : 車 又
輛 : ｜ 車 入 冂
輌 : ｜ 一 車 冂 山
輦 : ⺅ 車 人 大 二
輳 : 一 車 人 大 二
輻 : 口 車 田
輹 : 車 日 夂 乞
轅 : 口 車 土 衣
轂 : 士 車 冖 殳 几 又
輾 : ｜ 衣 車 二 尸
轌 : ヨ 雨 車
轉 : 車 十 寸 虫 田 厶
轆 : 鹿 車 比 广
轎 : ノ 口 車 大 冂
轗 : ノ 口 車 心 戈
轜 : 雨 而 車
轢 : 車 白 木 冫
轣 : 止 車 木 厂 禾
轤 : 皿 車 田 卜 匕 厂 虍
辜 : 口 十 辛 立
辟 : 口 十 辛 立 尸
辣 : ｜ 口 十 辛 木 立
辭 : 十 辛 爪 又 立 冂 ⽱
辯 : 言 十 辛 立
辷 : 一 ⻌
迚 : ｜ 口 ⻌
迥 : 口 ⻌ 冂
迢 : 口 ⻌ 刀
迪 : ｜ ⻌ 日 田
迯 : ⻌ 卜 夕
邇 : ｜ 一 ⻌ ハ 冂 爻
迴 : 口 ⻌ 囗
逅 : 口 ⻌ 厂
迹 : ⻌ 赤 ハ 亅 亠
迺 : ⻌ 西
逑 : ⻌ 水 丶 亠
逕 : 一 工 ⻌ 巛
逡 : ⻌ 儿 厶 夂
逍 : 月 ⻌ ⺌
逞 : 王 口 ⻌
逖 : 火 ⻌ ⺨
逋 : ⻌ 十 用 丶
逧 : 口 ⻌ 谷 ハ ㅅ
逶 : 禾 ⻌ 女
逵 : ⻌ 土 儿
逹 : ⻌ 十 辛 立 亠
迸 : ｜ ノ ⻌ 二 丷 廾 一
遏 : ⻌ 日 勹 匕
遐 : ｜ 口 ⻌ 又
遑 : 王 ⻌ 白
遒 : ⻌ 酉 丷
逎 : ⻌ 酉
遉 : 貝 目 ハ ⻌ 卜
逾 : ⺉ 月 ⻌ ㅅ 一
遖 : 干 ⻌ 十 丷 冂
遘 : ｜ 一 ⻌ 冂
遞 : ⻌ 卜 儿 匕 厂 虍
遨 : ⻌ 土 方 攵 乞
遯 : ⻌ 月 豕
遶 : ⻌ 土 儿
隨 : ノ 一 月 工 ⻖ ⻌
遲 : 牛 ⻌ 水 尸
邂 : 角 牛 ⻌ 刀
遽 : ⻌ 卜 匕 厂 虍 豕
邁 : ⻌ 田 ⽱ ⺾
邀 : ⻌ 白 方 攵 乞
邊 : 穴 ⻌ 自 方 儿 宀 目
邉 : 口 ⻌ 自 ハ 冖 目 儿
邏 : ⻌ 糸 幺 小 ⺲ 隹
邨 : 屯 ⻏
邯 : 甘 ⻏
邱 : 斤 ⻏ 一
邵 : 口 刀 ⻏
郢 : 王 口 ⻏
郤 : 口 谷 ハ ⻏ ㅅ
扈 : 戸 ⻏ 口 巴 一 尸
郛 : 子 爪 ⻏
鄂 : 口 二 ⻏
鄒 : ⻏ 勹 屮 ⺾
鄙 : 口 ⻏ 囗
鄲 : ｜ 口 十 田 ⻏
鄰 : 舛 米 ⻏ 夕
酊 : 酉 亅 一
酖 : 酉 尢 冖
酘 : 酉 殳 几 又
酣 : 甘 酉
酥 : 禾 酉
酩 : 口 酉 夕
酳 : 月 酉 幺
酲 : 王 口 酉
醋 : ｜ 一 酉 二 日
醉 : 十 人 酉 亠
醂 : 酉 木
醢 : ノ 一 口 皿 酉
醫 : 酉 矢 匚 殳 几 又 乞
醯 : 皿 川 酉 亠 厶
醪 : 羽 酉 ㅅ 冫 彡
醵 : 酉 卜 匕 厂 虍 豕
醴 : ｜ 一 口 豆 酉 日 丷
醺 : ｜ ノ 酉 ⺣
釀 : ｜ 衣 一 口 酉 亠
釁 : 臼 刀 酉 ハ 冂
釉 : ｜ 日 釆 米 田
釋 : 十 辛 ⺲ 釆 米 立 亠
釐 : ｜ 二 ハ 木 里 厂 攵 乞
釖 : 金 刀
釟 : 金 丷 ハ
釡 : 金 丷 ハ
釛 : 金 力
釼 : 金 刀 丶
釵 : 金 又 丶
釶 : 也 金 匕
鈞 : 金 冫 勹
釿 : 斤 金
鈔 : ノ 金 小
鈬 : 金 尸 丶
鈕 : ｜ 一 金
鈑 : 金 又 厂
鉞 : ｜ 金 戈
鉗 : 甘 金
鉅 : 金 巨
鉉 : 金 玄 亠 幺
鉤 : 金 口 勹
鉈 : 金 匕 宀
銕 : 弓 金 人 大
鈿 : 金 田
鉋 : 金 勹 已
鉐 : 金 口 石
銜 : 金 行 彳
銖 : ｜ ノ 牛 金 二 丷 木 ハ
銓 : 王 金 ㅅ
銛 : 金 口 舌
鉚 : ノ 金 卩
鋏 : 金 人 大 ㅅ
銹 : ノ 禾 金 乃
銷 : 金 月 ⺌
鋩 : 亡 金 ⺾
錏 : ｜ 一 金 二
鋺 : 金 夕 卩 宀
鍄 : 金 口 小 亠
錮 : 金 口 十 囗
錙 : 金 巛 田
錢 : 金 戈
錚 : ヨ 金 爪 亅
錣 : 金 又
錺 : 金 方 ⺾
錵 : ⺅ 金 ㅅ 匕 ⺾
錻 : 金 止 戈
鍜 : ｜ 金 又
鍠 : 王 金 白
鍼 : ノ 金 口 戈
鍮 : ⺉ 金 月 ㅅ 一
鍖 : 甘 金 儿 匚
鎰 : 金 皿 丷 ハ
鎬 : 金 口 高 亠 冂
鎭 : 金 丷 目 匕 一 ｜ ハ
鎔 : 金 穴 口 谷 丷 ㅅ 宀 ハ
鎹 : 金 ⻌ 人 大 二 ハ
鏖 : 金 鹿 比 广
鏗 : 金 臣 土 又
鏨 : 斤 金 車
鏥 : ⺅ 金 白 ㅅ 宀
鏘 : 金 寸 夕 爿
鏃 : 金 方 矢 乞
鏝 : 金 日 ⺲ 又
鏐 : 羽 金 ㅅ 冫 彡
鏈 : 金 ⻌ 車
鏤 : ｜ 一 金 口 女
鐚 : 金 心 二
鐔 : 金 十 西 日 曰
鐓 : 金 子 亠 囗 攵 乞
鐃 : 金 土 儿
鐇 : 金 田 釆 米
鐐 : 金 小 大 日 丷 亠 ハ
鐶 : 衣 金 口 ⺲
鐫 : 金 隹
鐵 : 王 金 口 土 戈
鐡 : 金 口 土 豆 丷 戈
鐺 : 金 口 ⺌ 田 冖
鑁 : 金 儿 凵 夂
鑒 : 金 臣 二 ⺲ 乞
鑄 : 金 口 工 士 寸
鑛 : 黄 金 田 ハ 广
鑠 : 金 白 木 冫
鑢 : 金 心 田 卜 匕 厂 虍
鑞 : 臼 金 巛 鼠 囗
鑪 : 金 皿 田 卜 匕 厂 虍
鈩 : 金 戸 一 尸
鑰 : ｜ 一 金 口 ㅅ 冂 冊 龠 廾
鑵 : 金 口 十 ⺾ 隹
鑷 : 金 耳
鑽 : ノ 貝 目 ハ 金 土 儿
鑚 : 貝 目 ハ 金 人 大 二 儿
鑼 : 金 糸 幺 小 ⺲ 隹
鑾 : 金 言 糸 幺 小
钁 : 金 又 目 隹
鑿 : 臼 干 金 丷 殳 几 又
閂 : 一 門
閇 : 卜 門
閊 : 山 門
閔 : 文 門
閖 : 水 門
閘 : ｜ 日 門 田
閙 : 巾 門 亠
閠 : 王 門 丶
閨 : 土 門
閧 : ｜ 一 二 ハ 門
閭 : 口 門 ノ
閼 : 方 門 ㅅ 冫
閻 : 臼 門 勹
閹 : 乙 大 日 門 奄
閾 : 口 門 戈
闊 : 口 ⺡ 舌 門
濶 : 口 ⺡ 舌 門
闃 : 犬 目 門
闍 : 日 門 ⺹
闌 : ｜ 日 ハ 木 門
闕 : 欠 丷 門 屮
闔 : 皿 土 門 厶
闖 : 馬 門 ⺣
關 : 門 幺
闡 : 口 十 田 門
闥 : 王 ⻌ 十 辛 土 門 羊 立 亠 二
闢 : 口 十 辛 門 立 尸
⻖ : ノ 十 ⻖
阨 : 卩 厂 ⻖
阮 : 二 儿 ⻖ 元
阯 : 止 ⻖
陂 : 皮 又 ⻖
陌 : 白 ⻖
陏 : ノ 一 月 ⻖
陋 : 人 冂 ⻖
陷 : 臼 ⻖ 勹
陜 : 人 大 ⻖
陞 : 土 廾 ⻖ ノ
陝 : 人 大 入 ⻖
陟 : ノ 止 小 ⻖
陦 : ノ 寸 二 ⻖ 土
陲 : ｜ ノ 一 ⻖
陬 : 耳 又 ⻖
隍 : 王 白 ⻖
隘 : 皿 丷 ⻖
隕 : 貝 目 ハ 口 ⻖
隗 : 鬼 田 儿 匕 ⻖ 厶
險 : 口 人 ㅅ ⻖ 一
隧 : ⻌ 丷 豕 ⻖
隱 : ヨ 工 心 爪 ⻖
隲 : ノ 小 馬 ⻖ ⺣
隰 : 日 幺 ⺣ ⻖
隴 : 月 立 ⻖
隶 : ヨ 水 隶
隸 : ヨ 示 二 小 水 木 亅 隶
隹 : 隹
雎 : 目 隹
雋 : 亅 冂 凵 隹
雉 : 矢 隹 乞
雍 : 亠 幺 隹
襍 : ⻂ 木 隹
雜 : 人 木 亠 隹
霍 : 雨 隹
雕 : 口 士 冂 隹
雹 : 雨 勹 已
霄 : 雨 月 ⺌
霆 : 雨 王 廴
霈 : 雨 巾 ⺡ 亠
霓 : 雨 臼 儿
霎 : 雨 女 立
霑 : 雨 口 ⺡ 卜
霏 : 雨 非
霖 : 雨 木
霙 : 雨 大 冂 ⺾ 冖
霤 : 雨 田 刀 厶
霪 : 雨 王 ⺡ 爪
霰 : ｜ 一 雨 月 二 攵 乞
霹 : 雨 口 十 辛 立 尸
霽 : 雨 亠 齊 刀 氏 廾
霾 : 雨 里 豸
靄 : 雨 言 日 勹 匕
靆 : ヨ 雨 ⻌ 水 二 厶 隶
靈 : 雨 口 工 人
靂 : 雨 止 木 厂
靉 : 雨 心 爪 二 冖 厶 夂
靜 : ノ ヨ 月 ⺌ 青 爪 土 二 亅 亠
靠 : ノ 口 土 非
靤 : 面 勹 已
靦 : 見 面
靨 : 犬 日 面 目 厂
勒 : 革 力
靫 : 革 又 丶
靱 : 革 刀
靹 : 革 人 冂
鞅 : 革 口 人 大 冂 凵 冖
靼 : 革 日 一
鞁 : 革 皮 又
靺 : ｜ 革 口 ハ 木 亠 凵
鞆 : 革 人 冂
鞋 : 革 土
鞏 : 革 工 丶 几
鞐 : 革 卜
鞜 : 革 水 日
鞨 : 革 日 勹 匕
鞦 : 火 禾 革
鞣 : ｜ 革 口 矛 木 凵 マ
鞳 : 革 口 ㅅ ⺾ 一
鞴 : 革 用 厂 ⺾
韃 : 王 革 ⻌ 土 丷 羊
韆 : 革 ⻌ 西 ハ 已
韈 : ノ 革 ⺲ 戈 ⺾
韋 : 韋 口
韜 : 臼 爪 韋 口
韭 : 韭
齏 : 亠 齊 韭 刀 氏 廾
韲 : 亠 齊 韭 刀 氏 廾
竟 : 音 日 立 儿
韶 : 音 口 刀 日 立
韵 : 音 日 立 冫 勹
頏 : 貝 目 ハ 頁 亠 儿
頌 : 貝 目 ハ 頁 厶
頸 : 貝 目 ハ 工 巛 頁
頤 : 貝 目 ハ 臣 頁 匚
頡 : 貝 目 ハ 口 士 頁
頷 : 貝 目 ハ 口 頁 ㅅ 一
頽 : 禾 貝 目 ハ 頁 几
顆 : ｜ 貝 目 ハ 田 日 頁 木
顏 : 貝 目 ハ 文 頁 厂 彡
顋 : 貝 目 ハ 心 田 頁
顫 : 貝 目 ハ 口 日 頁 亠 囗 一
顯 : 貝 目 ハ 日 頁 幺 ⺣
顰 : ノ 貝 目 ハ 止 十 小 田 頁
顱 : 貝 目 ハ 皿 田 頁 卜 匕 厂 虍
顴 : 貝 目 ハ 口 十 頁 ⺾ 隹
顳 : 貝 目 ハ 耳 頁
颪 : 風 卜 虫 几 一
颯 : 風 立 虫 几
颱 : 口 風 厶 虫 几
颶 : ハ 風 目 虫 几
飄 : 示 二 小 西 風 虫 几
飃 : 示 二 小 西 風 虫 几
飆 : 犬 風 虫 几
飩 : 食 屯
飫 : ノ 食 大
餃 : 食 父 亠
餉 : 口 食 冂
餒 : 女 食 爪
餔 : 十 食 用 丶
餘 : 干 食 二 ハ ㅅ 亅 一
餡 : 臼 食
餝 : 食 方 ⺾
餞 : 食 戈
餤 : 火 食
餠 : ｜ 干 食
餬 : 口 十 食 月
餮 : 食 ㅅ 彡 歹
餽 : 鬼 食 田 儿 匕 厶
餾 : 食 田 卩 厶 刀
饂 : 皿 食 日
饉 : ｜ 一 食 二 ⺾ 土 口
饅 : 食 日 ⺲ 又
饐 : 口 士 食 豆 丷 冖
饋 : ｜ 一 貝 目 ハ 口 食
饑 : 食 丶 幺 戈 ノ
饒 : 食 土 儿
饌 : ｜ 食 二 ハ 已
饕 : 口 食 卜 儿 匕 厂 虍
馗 : 九 自 首 丷 目
馘 : 口 自 首 丷 目 戈
馥 : 禾 香 日 夂 乞
馭 : 馬 又 ⺣
馮 : 馬 冫 ⺣
馼 : 馬 文 ⺣
駟 : 馬 儿 囗 ⺣
駛 : ノ 口 馬 ⺣
駝 : 馬 匕 宀 ⺣
駘 : 口 馬 厶 ⺣
駑 : 女 馬 又 ⺣
駭 : 人 馬 亠 ⺣ ノ 丶
駮 : 馬 父 亠 ⺣
駱 : 口 馬 夂 ⺣
駲 : ｜ ノ 川 馬 丶 ⺣
駻 : 干 日 馬 ⺣
駸 : ヨ 馬 又 冖 ⺣
騁 : ｜ 日 馬 一 勹 田 ⺣
騏 : 甘 馬 ハ ⺣
騅 : 馬 隹 ⺣
駢 : ｜ ノ 二 馬 丷 廾 ⺣ 一
騙 : ｜ 一 戸 馬 冂 冊 尸 ⺣ 廾
騫 : ｜ 一 馬 ハ 宀 ⺣
騷 : 虫 馬 又 丶 ⺣
驅 : 口 馬 匚 品 ⺣
驂 : 大 馬 厶 彡 ⺣ ㅅ
驀 : 大 日 馬 ⺾ ⺣
驃 : 示 二 小 西 馬 ⺣
騾 : 糸 幺 小 田 馬 ⺣
驕 : ノ 口 大 馬 冂 ⺣
驍 : 土 馬 儿 ⺣
驛 : 十 辛 馬 ⺲ 立 亠 ⺣
驗 : 口 人 馬 ㅅ ⺣ 一
驟 : 衣 耳 馬 又 ⺣
驢 : 皿 田 馬 卜 匕 厂 虍 ⺣
驥 : ｜ 田 二 馬 ハ 匕 爿 ⺣
驤 : ｜ 衣 二 馬 ハ 亠 ⺣ 井
驩 : 口 十 馬 ⺾ 隹 ⺣
驫 : 馬 ⺣
驪 : 鹿 馬 比 亠 冂 广 ⺣
骭 : 干 月 骨 冂 冖
骰 : 月 骨 冂 冖 殳 几 又
骼 : 月 口 骨 冂 冖 夂
髀 : 月 骨 十 田 冂 冖
髏 : ｜ 一 月 口 骨 女 冂 冖
髑 : 月 骨 虫 ⺲ 冂 冖 勹
髓 : ノ 一 月 工 骨 ⻌ 冂 冖
體 : ｜ 月 口 骨 豆 日 丷 冂 冖
髞 : 口 高 木 亠 冂 品
髟 : 長 彡 髟
髢 : 也 長 匕 彡 髟
髣 : 長 方 彡 髟
髦 : 長 毛 彡 髟
髯 : ｜ 一 長 冂 厶 彡 髟 十
髫 : 口 長 刀 彡 髟
髮 : 長 彡 攵 髟 又
髴 : ｜ ノ 弓 長 彡 髟
髱 : 長 勹 已 彡 髟
髷 : ｜ 長 日 厶 彡 髟
髻 : 口 士 長 彡 髟
鬆 : 長 ハ 木 厶 彡 髟
鬘 : 長 日 ⺲ 又 彡 髟
鬚 : 貝 目 ハ 長 頁 彡 髟
鬟 : 衣 一 口 長 ⺲ 彡 髟
鬢 : ノ 貝 目 ハ 小 長 宀 彡 髟
鬣 : 臼 鼠 長 囗 彡 髟 巛
鬥 : 鬥
鬧 : 巾 亠 鬥
鬨 : ｜ 二 ハ 亅 鬥
鬩 : 臼 儿 鬥
鬪 : 口 寸 豆 丷 鬥
鬮 : 亀 鬥 乙 勹 田
鬯 : 凵 匕 鬯
鬲 : 口 儿 冂 鬲
魄 : 鬼 田 白 儿 匕 厶
魃 : 鬼 田 丶 儿 匕 攵 厶
魏 : 禾 鬼 女 田 儿 匕 厶
魍 : 亡 鬼 田 丷 儿 冂 匕 厶
魎 : ｜ 鬼 田 入 儿 冂 厶 匕
魑 : 鬼 田 亠 儿 凵 匕 ⽱ 厶
魘 : 鬼 月 犬 田 日 儿 匕 厂 厶
魴 : 魚 田 方 ⺣
鮓 : ｜ ノ 魚 田 ⺣
鮃 : 干 魚 田 丷 ⺣
鮑 : 魚 田 勹 已 ⺣
鮖 : 魚 口 石 田 ⺣
鮗 : 魚 田 冫 夂 ⺣
鮟 : 魚 女 田 宀 ⺣
鮠 : 魚 田 卩 厂 ⺣
鮨 : 魚 田 日 匕 ⺣
鮴 : ⺅ 魚 田 木 ⺣
鯀 : ノ 魚 糸 幺 小 田 ⺣
鯊 : ノ 魚 ⺡ 小 田 ⺣
鮹 : 魚 月 ⺌ 田 ⺣
鯆 : 魚 十 田 用 丶 ⺣
鯏 : 禾 ⺉ 魚 田 ⺣
鯑 : ノ 一 魚 巾 田 ⺣
鯒 : 魚 田 用 ⺣
鯣 : ノ 魚 田 日 勹 ⺣ 勿
鯢 : 臼 魚 田 儿 ⺣
鯤 : 魚 田 日 比 ⺣
鯔 : 魚 巛 田 ⺣
鯡 : 魚 田 非 ⺣
鰺 : 魚 田 ㅅ 厶 彡 ⺣
鯲 : 魚 田 方 ㅅ 冫 ⺣
鯱 : 魚 田 卜 儿 匕 厂 ⺣ 虍
鯰 : 魚 心 田 ㅅ ⺣ 一
鰕 : ｜ 魚 口 田 又 ⺣
鰔 : ノ 魚 口 田 戈 ⺣
鰉 : 王 魚 田 白 ⺣
鰓 : 魚 心 田 ⺣
鰌 : 魚 田 酉 ハ ⺣
鰆 : 魚 人 大 田 二 日 ⺣
鰈 : 魚 田 木 世 ⺣
鰒 : 魚 田 日 夂 ⺣ 乞
鰊 : ｜ 魚 口 田 ⺲ 丷 木 ⺣
鰄 : ノ 魚 女 田 戈 ⺣
鰮 : 魚 皿 人 田 囗 ⺣
鰛 : 魚 皿 田 日 ⺣
鰥 : ｜ 魚 田 ⺲ 冫 ⺣
鰤 : ｜ 魚 巾 口 田 冂 ⺣
鰡 : 魚 田 刀 厶 ⺣
鰰 : ｜ 魚 田 ⺭ ⺣
鱇 : ヨ 魚 水 田 广 ⺣ 隶
鰲 : 魚 田 土 方 攵 ⺣ 亠 二 乞
鱆 : 音 魚 十 田 日 立 ⺣
鰾 : 魚 示 二 小 西 田 ⺣
鱚 : 魚 口 士 十 田 豆 丷 ⺣
鱠 : 魚 田 日 ⺲ ㅅ ⺣ 一
鱧 : ｜ 魚 田 豆 日 ⺣
鱶 : 王 魚 艮 食 田 丷 羊 ⺣
鱸 : 魚 皿 田 卜 匕 厂 ⺣ 虍
鳧 : 鳥 几 ⺣
鳬 : 鳥 几
鳰 : 鳥 入 ⺣
鴉 : 牙 鳥 ⺣
鴈 : ⺅ 鳥 厂 ⺣
鳫 : 鳥 厂 ⺣
鴃 : 人 大 鳥 二 ⺣ ユ
鴆 : 鳥 尢 ⺣ 冖
鴪 : 穴 鳥 ハ 宀 ⺣ 儿
鴦 : 大 鳥 ⺣ 冖
鶯 : 火 鳥 冖 ⺣
鴣 : 口 十 鳥 ⺣
鴟 : 氏 鳥 ⺣
鵄 : 至 鳥 土 厶 ⺣
鴕 : 鳥 匕 宀 ⺣
鴒 : 鳥 ㅅ 卩 ⺣ 一
鵁 : 鳥 父 亠 ⺣
鴿 : 口 鳥 ㅅ ⺣ 一
鴾 : 牛 鳥 厶 ⺣
鵆 : 行 鳥 彳 ⺣
鵈 : 耳 鳥 ⺣
鵝 : 鳥 亅 戈 ⺣
鵞 : 鳥 亅 戈 ⺣
鵤 : 角 鳥 ⺣
鵑 : 月 口 鳥 ⺣
鵐 : 工 人 鳥 ⺣
鵙 : 貝 目 ハ 鳥 ⺣
鵲 : ｜ 一 鳥 日 ⺣
鶉 : 口 子 鳥 亠 ⺣
鶇 : ｜ 鳥 日 ハ 木 ⺣ 田
鶫 : ｜ 口 鳥 ⺲ 丷 木 ⺣
鵯 : 十 鳥 田 ⺣
鵺 : 鳥 夕 亠 ⺣ ⺅ 夕
鶚 : 口 鳥 二 ⺣ 勹
鶤 : 車 鳥 冖 ⺣
鶩 : 鳥 矛 攵 ⺣ 乞
鶲 : 羽 鳥 ハ 冫 厶 ⺣
鷄 : 大 鳥 爪 幺 ⺣
鷁 : 皿 鳥 丷 ⺣
鶻 : 月 骨 鳥 冂 冖 ⺣
鶸 : 弓 鳥 冫 ⺣
鶺 : 月 人 鳥 ⺣ 二
鷆 : 鳥 ハ 目 匕 ⺣
鷏 : 十 鳥 ハ 目 ⺣
鷂 : 缶 鳥 夕 凵 ⺣
鷙 : 九 十 辛 鳥 立 丶 亠 ⺣
鷓 : 一 鳥 凵 广 ⺣
鷸 : 口 鳥 矛 儿 冂 ⺣
鷦 : 鳥 ⺣ 隹
鷭 : 鳥 田 釆 米 ⺣
鷯 : 小 鳥 日 丷 大 亠 ⺣
鷽 : 臼 鳥 冖 ⺣ 爻
鸚 : 貝 目 ハ 女 鳥 ⺣
鸛 : 口 鳥 ⺣ ⺾ 隹
鸞 : 言 糸 幺 小 鳥 ⺣
鹵 : 十 囗 鹵
鹹 : ノ 口 卜 囗 戈 鹵 十
鹽 : 皿 十 臣 囗 鹵 乞
麁 : 鹿 比 广 勹
麈 : 王 鹿 比 丶 广
麋 : 鹿 比 米 广
麌 : 口 鹿 ハ 比 广 大
麒 : 甘 鹿 ハ 比 广
麕 : 禾 鹿 比 囗 广
麑 : 臼 鹿 比 儿 广
麝 : 鹿 身 寸 比 广
麥 : 人 十 夂
麩 : 人 二 十 夂 大
麸 : 人 土 二 麦 亠 夂 大
麪 : 止 人 十 疋 夂
麭 : 人 十 勹 夂 已
靡 : 非 麻 木 广
黌 : 臼 黄 田 ハ 冖 爻
黎 : 黍 勿 禾 水
黏 : 黍 口 卜 禾 水
黐 : 黍 亠 凵 ⽱ 禾 水
黔 : 黒 里 ㅅ ⺣ 一
黜 : ｜ 黒 山 里 ⺣
點 : 口 黒 卜 里 ⺣
黝 : 黒 里 力 幺 ⺣
黠 : 口 黒 士 里 ⺣
黥 : 口 黒 小 里 亠 ⺣
黨 : 口 黒 ⺌ 里 冖 ⺣
黯 : 音 黒 日 里 立 ⺣
黴 : 黒 山 里 彳 攵 ⺣ 乞
黶 : 犬 黒 日 里 厂 ⺣
黷 : 貝 目 ハ 黒 士 里 儿 囗 ⺣ ⺲
黹 : ハ 冂 黹 丷
黻 : ハ 丶 冂 黹 丷 ノ 一
黼 : 十 ハ 用 丶 冂 黹 丷
黽 : 黽
鼇 : 土 方 攵 黽 亠 二 乞
鼈 : 小 ⺌ 冂 攵 黽 乞
皷 : 鼓 口 士 丷 皮 十 又 支 豆
鼕 : 鼓 口 士 支 ハ 冫 夂 又 十 豆 丶
鼡 : 用 ⺌
鼬 : ｜ 臼 鼠 日 田
鼾 : 干 自 田 鼻 目 廾
齊 : 齊 亠 刀 氏 廾
齒 : 止 歯 人 凵 米
齔 : 止 歯 米 凵 匕
齣 : 口 止 歯 米 凵 勹
齟 : 止 歯 米 目 凵
齠 : 口 止 歯 刀 米 凵
齡 : 止 歯 人 ㅅ 凵 卩 米 一
齦 : 艮 止 歯 米 凵
齧 : 止 歯 土 刀 米 亠 凵 二
齬 : 口 止 歯 米 凵 五
齪 : 口 止 歯 足 米 凵
齷 : 止 至 歯 土 米 凵 厶 尸
齲 : ノ 止 歯 虫 米 冂 凵 ⽱
齶 : 口 止 歯 二 米 凵 勹
龕 : 月 口 立 ㅅ 一
龜 : 亀 乙 勹 田
龠 : 一 口 ㅅ 龠 冊 廾
堯 : 土 儿 一
槇 : 木 貝 目 ハ ｜ 一
遙 : ⻌ 夕 丶 缶
瑤 : 王 夕 丶 缶
凜 : 冫 亠 禾 口
熙 : ⺣ 已 匚 口
丂 : 一 勹
丄 : 一 ｜
丅 : 一 ｜
丌 : 一 ｜ ノ
丒 : 一 丶 ノ 勹
丟 : 厶 王
丣 : 一 ｜ ノ 口
两 : 一 人 冂
丨 : ｜
丫 : ｜ 丶 ノ 丷
丮 : ｜ 二
丯 : ｜ 彡
丰 : 一 ｜ 二
丵 : 一 丶 ノ 丷 十 干
乀 : 丶
乁 : 一 丶
乄 : 丶 ノ
乇 : 一 ノ 乙
乑 : ｜ 丶 ノ
乚 : 乙
乜 : 乙 匕
乣 : 乙 幺
乨 : 乙 厶 口
乩 : 乙 卜 口
乴 : 一 ノ 乙 亅 斤
乵 : 乙 十 立 辛
乹 : 乙 十 日
乿 : 乙 小 幺 爪 糸
亍 : 亅 二
亖 : 二
亗 : 二 山
亝 : 二 厶
亯 : 一 丶 亠 口 日 曰
亹 : 一 ｜ ノ 亠 冂 冖 口 ヨ 目
仃 : 一 亅 ⺅
仐 : ㅅ 十
仚 : ㅅ 山
仛 : 一 ノ 乙 ⺅
仠 : 一 ⺅ 十 干
仡 : 一 ノ 乙 ⺅
仢 : 丶 ⺅ 勹
仨 : 一 二 ⺅
仯 : ノ ⺅ 小
仱 : 一 丶 ⺅ ㅅ
仳 : ⺅ 匕 比
仵 : 一 ノ ⺅ 十 干
份 : ⺅ ハ 刀
仾 : 一 ⺅ ヨ 彑
仿 : 一 丶 ノ ⺅ 方
伀 : ⺅ ハ 厶
伂 : 一 ｜ ⺅ 冂 巾
伃 : 一 亅 ⺅ マ
伈 : ⺅ 心
伋 : 丶 ⺅ 又 乃 及
伌 : ⺅ 卩 厂
伒 : ⺅ 斤
伕 : 一 二 人 ⺅ 大
伖 : 一 ノ ⺅ 又
众 : 人 ㅅ
伙 : ⺅ 火
伮 : ⺅ 又 女
伱 : ⺅ ㅅ 小
你 : 一 ノ ⺅ 小
伳 : 一 ｜ ⺅ 十 世
伵 : ⺅ ハ 口
伷 : ｜ ⺅ 日 田
伹 : 一 ⺅ 目
伻 : 一 ⺅ ハ 十 干
伾 : 一 ｜ 丶 ノ ⺅
佀 : ｜ ⺅ 口
佂 : 一 ⺅ 止
佈 : 一 ｜ ノ ⺅ 冂 巾
佉 : ⺅ 厶 土
佋 : ⺅ 刀 口
佌 : ⺅ 匕 止
佒 : ⺅ 大
佔 : ⺅ 卜 口
佖 : ノ ⺅ 心
佘 : 二 ㅅ 小 示
佟 : 丶 ⺅ 夂
佣 : 一 ｜ ⺅ 用
佪 : ⺅ 口 囗
佬 : ノ ⺅ 匕 土 ⺹
佮 : 一 ⺅ ㅅ 口
佱 : 一 ㅅ 止
佷 : ⺅ 艮
佸 : ⺅ 口 舌
佹 : ⺅ 勹 卩 厂
佺 : ⺅ ㅅ 王
佽 : 一 人 ⺅ 勹 欠
佾 : ⺅ ハ 月
侁 : 一 ノ ⺅ 儿 十 土
侂 : ノ ⺅ 匕 广
侄 : 一 ⺅ 厶 土
侅 : ノ 亠 人 ⺅ 幺 玄
侉 : 一 二 ⺅ 勹 大
侊 : 一 ⺅ 儿 ⺌
侌 : 一 丶 ㅅ 厶 ユ
侎 : ⺅ 米
侐 : ⺅ 皿 血
侒 : ⺅ 女 宀
侓 : ｜ 二 ⺅ ヨ 聿
侔 : ⺅ 厶 牛
侗 : 一 ⺅ 冂 口
侙 : ⺅ 工 弋
侚 : ⺅ 勹 日
侞 : ⺅ 口 女
侟 : 一 ｜ ノ ⺅ 子
侲 : ⺅ 厂 衣 辰
侷 : ⺅ 勹 口 尸
侹 : ⺅ 廴 王
侻 : ⺅ 儿 丷 口
侼 : 一 ⺅ 冖 十 子
侽 : ⺅ 力 田
侾 : ノ ⺅ 土 子 ⺹
俀 : ⺅ 女 爪
俁 : 一 丶 ノ ⺅ 口 大
俅 : 一 丶 ⺅ 水
俆 : 亅 二 ⺅ ㅅ ハ 小 示
俈 : ノ ⺅ 口 土
俉 : 一 二 ⺅ 口 五
俋 : 乙 ⺅ 口 已 ⻏ 巴
俌 : 一 ｜ 丶 二 ⺅ 十 用
俍 : 丶 ⺅ 艮
俏 : ⺅ 小 ⺌ 月
俒 : 一 ⺅ 儿 宀
俜 : 一 ｜ ⺅ 勹 十 口 田
俠 : 人 ⺅ 大
俢 : ⺅ 夂 彡
俰 : ノ ⺅ 口 木 禾
俲 : 亠 ⺅ 力 父
俼 : 亠 ⺅ 厶 月
俽 : 人 ⺅ 勹 斤 欠
俿 : ⺅ 儿 几 匕 卜 厂 虍
倀 : ⺅ 長
倁 : 一 ノ ⺅ 口 大 矢
倄 : 一 丶 ノ ⺅ 月
倇 : ⺅ 卩 夕 宀
倊 : ⺅ ハ 厶 心
倌 : ｜ ⺅ 口 宀
倎 : 一 ｜ ⺅ ハ 冂 日 冊 廾
倐 : ｜ ⺅ 夂 火
倓 : ⺅ 火
倗 : ⺅ 月
倘 : ⺅ 冂 口 小 ⺌
倛 : 一 ｜ ⺅ ハ 甘 目
倜 : ｜ 二 ⺅ 冂 口 土
倝 : 人 十 日 曰
倞 : 亠 ⺅ 口 小
倢 : 一 ｜ ⺅ 土 ヨ 疋 走
倧 : 二 ⺅ 宀 小 示
倮 : ⺅ 木 田
倰 : ⺅ ハ 土 夂
倲 : 一 ⺅ 口 日 木
倳 : 一 亅 ⺅ 口 ヨ
倵 : 一 丶 ⺅ 弋 止
偀 : ⺅ 大 ⺾
偁 : 一 ｜ 二 ⺅ 冂 月 爪
偂 : 一 丶 ⺅ 丷 冂 ⺉ 月
偅 : 一 ノ ⺅ 車
偆 : 一 二 ⺅ 大 日
偊 : ノ ⺅ 冂 厶 口 ⽱ 虫
偌 : 一 ノ ⺅ 口 ⺾
偎 : ⺅ 田 衣
偑 : ノ ⺅ 冂 虫 風
偒 : 一 ノ ⺅ 勹 日 曰 勿
偓 : 一 ⺅ 厶 土 尸 至
偗 : ノ ⺅ 小 目
偙 : 一 ｜ 丶 ⺅ 丷 冂 冖 巾 立
偟 : ⺅ 日 王 白
偠 : ⺅ 女 西
偢 : ノ ⺅ 木 火 禾
偣 : ⺅ 日 立 音
偦 : ⺅ 月 疋
偧 : ⺅ 夕 大
偪 : 一 ⺅ 口 田
偭 : ⺅ 面
偰 : 一 ｜ 二 ⺅ 刀 大 彡
偱 : 一 ⺅ 十 厂 斤 目 自
倻 : ⺅ ⻏ 耳
傁 : ｜ ノ ⺅ 十 又 ヨ 支 臼
傃 : 一 二 ⺅ 土 小 幺 糸
傄 : 丶 ノ ⺅ 大 目
傆 : ⺅ 厂 小 日 白
傊 : ⺅ ハ 口 目 貝
傎 : ⺅ ハ 匕 十 目
傏 : ｜ ⺅ 口 广 ヨ
傐 : 亠 ⺅ 冂 口 高
傒 : ⺅ 大 幺 爪
傓 : 一 ノ ⺅ 冫 厂 尸 戸 羽
傔 : 一 ノ ⺅ ヨ 木 禾
傖 : 一 丶 ⺅ ㅅ 口 尸 戸 日
傛 : ⺅ ㅅ ハ 口 宀 谷
傜 : 丶 ⺅ 凵 夕 山 爪 缶
傞 : 一 ノ 二 ⺅ 丷 工 王 羊
傟 : ⺅ ハ 冫 厶 羽
傠 : ⺅ 寸 言
傡 : ⺅ 立
傢 : ⺅ 宀 豕
傪 : ⺅ ㅅ 厶 彡
傯 : 丶 ノ ⺅ 勹 口 囗 夂 心
傰 : ⺅ 山 月
傹 : ⺅ 儿 日 曰 立 音
傺 : 丶 二 ⺅ ㅅ 夕 小 示
傽 : ⺅ 十 日 曰 立 音
僀 : 一 ｜ 乙 ⺅ 冂 冖 十 巾 廾
僃 : ⺅ 勹 ⺾ 用
僄 : 二 ⺅ 小 示 西
僇 : ⺅ ㅅ 冫 彡 羽
僌 : ⺅ 攵 車
僎 : ｜ 二 ⺅ ハ 已
僐 : 一 ｜ ⺅ 丷 口 王 羊
僓 : 一 ｜ ⺅ ハ 口 土 目 虫 貝
僔 : 一 ⺅ 儿 ハ 丷 寸 酉
僘 : ⺅ 冂 口 小 ⺌ 攵
僜 : 一 ⺅ 丷 口 癶 豆
僝 : ⺅ 子 尸
僟 : 人 ⺅ 幺 戈
僢 : ｜ ⺅ 冖 夕 爪 舛
僤 : ⺅ 十 口 日 田
僦 : 丶 亠 ⺅ 口 小 尢 尤
僨 : ⺅ ハ 十 ⺾ 目 貝
僩 : ⺅ 月 門
僯 : ⺅ 夕 米 舛
僱 : 一 丶 ⺅ 尸 戸 隹
僶 : ⺅ 黽
僺 : ⺅ 口 木
僾 : ⺅ 冖 夂 心 爪
儃 : 一 亠 ⺅ 口 囗 日
儆 : ⺅ 勹 口 ⺾ 攵
儇 : 一 丶 ノ ⺅ 口 ⺲ 衣
儈 : 一 丶 ノ ⺅ ㅅ 丷 口 日
儋 : ⺅ 儿 ハ 冖 勹 厂 言
儌 : ⺅ 攵 方 日 白
儍 : 丶 ノ ⺅ 儿 ハ 凵 夂
儎 : ⺅ 十 土 戈 車
僲 : ⺅ 夕 西 舛
儐 : 一 ｜ ノ ハ 宀 目 貝
儗 : 一 ノ ⺅ 匕 マ 大 疋 矢
儙 : 一 ｜ ⺅ ⻌ 口 虫
儛 : 一 ｜ ノ ⺅ 夕 舛 無
儜 : 一 亅 ⺅ 宀 心 ⺲
儝 : ⺅ 冖 木 火
儞 : 一 ｜ 丶 ノ ⺅ ハ 冂
儣 : ｜ 二 ⺅ ハ 广 日 田 黄
儧 : 一 ⺅ ハ 大 目 貝
儨 : ⺅ ハ 斤 目 貝
儬 : 二 亠 ⺅ ハ 土 月 目 貝 青
儭 : 一 ⺅ 儿 小 目 立 見
儯 : 一 ⺅ 丷 大 馬
儱 : 一 乙 ⺅ 月 立
儳 : 一 ｜ 丶 ノ 乙 ⺅ 儿 冖 勹 匕 口 比 免
儴 : 一 ｜ 丶 二 亠 ⺅ 口 衣
儵 : ｜ ⺅ 丷 夂 攵 ⺣ 里 黒
儸 : ⺅ 小 幺 ⺲ 糸 隹
儹 : ノ ⺅ 儿 ハ 土 目 貝
兂 : 一 ノ 乙 二 尢
兊 : 儿 ハ 厶
兏 : 一 儿 卜 厂
兓 : 一 尢
兕 : 一 ｜ 儿
兗 : 亠 儿 ハ 口
兘 : 二 儿 厶 口 元
兟 : ノ 儿 土
兤 : 一 ｜ 二 亠 儿 ハ ⺌ 广 日 田 黄
兦 : 乙 人
兾 : ｜ 二 ハ 丷 田
冃 : 二 冂
冄 : 二 冂
冋 : 冂 口
冎 : 冂 口 囗
冘 : ノ 乙 冖 尢
冝 : 一 冖 目
冡 : 一 冖 豕
冣 : 冖 又 耳
冭 : 一 丶 ノ 大
冸 : ｜ 二 ハ 丷 冫 小
冺 : 一 冫 尸 氏
冼 : ノ 儿 冫 土
冾 : 一 ㅅ 冫 口
冿 : ｜ 二 冫 ヨ 聿
凂 : 一 ｜ ノ 乙 儿 冫 勹 口 免
凈 : 亅 冫 ヨ 爪
减 : 一 ノ 冫 厂 口 戈
凑 : 一 丶 ノ 二 冫 大
凒 : 丷 冫 口 山 豆
凓 : 冫 木 西
凕 : 亠 ハ 冖 冫 日 曰
凘 : 一 ハ 冫 斤 甘
凞 : ノ 冫 匚 已 ⺣ 臣
凢 : ノ 乙 几 广
凥 : 几 尸
凮 : 一 ノ 几 日 白
凲 : ｜ ハ 丷 几 ヨ
凳 : 一 ㅅ 丷 几 口 癶 豆
凴 : 冫 几 馬
凷 : 凵 土
刁 : 一 亅
刂 : ⺉
刅 : 丶 ノ ハ 刀
划 : ⺉ 戈
刓 : 二 儿 ⺉ 元
刕 : 刀
刖 : ⺉ 月
刘 : ⺉ 文
刢 : 丶 ㅅ ⺉ マ
刨 : ⺉ 勹 已
刱 : 一 ｜ 丶 ノ 二 ハ 刀 井
刲 : ⺉ 土
刵 : ⺉ 耳
刼 : 一 丶 ノ ㅅ 刀 厶
剅 : 一 丷 ⺉ 口 豆
剉 : 人 ⺉ 土
剕 : ⺉ 非
剗 : ⺉ 戈
剘 : 一 ｜ 二 ハ ⺉ 甘
剚 : 一 亅 ⺉ 口
剜 : ⺉ 卩 夕 宀
剟 : ⺉ 又
剠 : 亠 ⺉ 口 小
剡 : ⺉ 火
剦 : 乙 ⺉ 大 日 奄
剮 : 冂 ⺉ 口 囗
剷 : 一 丶 ノ 亠 ⺉ 厂 土 牛 立
剸 : 一 ⺉ 厶 寸 日 虫
剹 : ㅅ 冫 ⺉ 彡 羽
劀 : ハ 冂 ⺉ マ 口 矛
劂 : 一 人 丷 ⺉ 勹 厂 屮 欠
劅 : ⺉ 勹 ⺲ 虫
劊 : 一 ｜ 丶 ノ ㅅ 丷 ⺉ 口 日
劌 : 一 ノ 亅 ⺉ 厂 戈 止
劓 : 一 ｜ ノ ⺉ 廾 田 目 自 鼻
劕 : ハ ⺉ 斤 目 貝
劖 : 一 ｜ ノ 乙 儿 ⺉ 勹 匕 口 比 免
劗 : ノ 儿 ハ ⺉ 土 目 貝
劘 : 一 ｜ ノ 儿 ⺉ 十 广 木 非
劚 : ｜ 丶 ノ ⺉ 勹 尸 水 ⺲ 虫
劜 : 乙 力
劤 : 力 斤
劥 : 一 丶 亠 几 力
劦 : 力
劧 : 力 手
劯 : 力 口 石
劰 : 力 日 白
劶 : 一 力 厂 口
劷 : 一 ノ 二 丷 力 王 羊
劸 : 力 土
劺 : 力 厶 牛
劻 : 力 匚 王
劽 : ⺉ 力 歹
勀 : ノ 儿 力 十 口
勄 : 一 ノ 力 毋 母
勆 : 丶 力 厶 日 曰
勈 : 力 マ 用
勌 : 一 二 ハ 力 卩 大
勏 : 力 口 立
勑 : 人 力 木
勔 : 力 面
勖 : 二 冂 力 目
勛 : ハ 力 口 目 貝
勜 : ハ 冫 力 厶 羽
勡 : 二 力 小 示 西
勥 : 力 口 弓 虫
勨 : ノ 力 勹 口 豕
勩 : 一 ｜ ハ 力 目 世 貝
勪 : 一 丶 ノ 冂 力 口 大
勬 : 一 丷 力 大 小 幺 糸
勰 : 力 心 田
勱 : 冂 力 厶 ⺾ 田 ⽱
勴 : 力 匕 卜 厂 心 田 虍
勶 : 一 丶 亠 力 厶 彳 攵 月
勷 : 一 ｜ 二 亠 力 口 衣
匀 : 一 丶 勹
匃 : 人 勹
匊 : 勹 米
匋 : 凵 勹 山 缶
匌 : 一 ㅅ 勹 口
匑 : 勹 弓 身
匓 : 几 勹 厶 又 日 殳 艮
匘 : 丶 ノ 匕 口 巛
匛 : 丶 勹 匚 夂
匜 : ｜ 乙 匕 匚 也
匞 : 匚 工
匟 : 亠 几 匚
匥 : 匚 厶 廾
匧 : 人 匚 大
匨 : 匚 士 爿
匩 : 匚 屮 山 王
匫 : ノ 勹 匚 日 曰 勿
匬 : 一 ㅅ ⺉ 匚 月
匭 : 匚 九 車
匰 : 匚 十 口 日 田
匲 : 一 丶 ノ 匚 口 大
匵 : 儿 ハ 匚 口 士 ⺲ 貝
匼 : 一 ㅅ 匚 口
匽 : 匚 女 日
匾 : 一 ｜ 丶 ノ 亅 冂 匚 尸 戸 冊 廾
卂 : 乙 十
卌 : 一 ｜
卋 : 一 ｜ 凵 十
卙 : 一 ｜ ハ 匚 十 甘
卛 : 丶 ノ 十 幺 糸 言
卡 : 一 卜 土
卣 : 一 卜 口
卥 : 丶 ノ 卜 口 夕
卬 : 卩 厂
卭 : 卩 工
卲 : 刀 卩 口
卹 : 卩 皿 血
卾 : 二 勹 卩 口
厃 : 勹 厂
厇 : 一 ノ 乙 厂
厈 : 一 十 厂 干
厎 : 丶 厂 氏
厓 : 厂 土
厔 : 一 厂 厶 土 至
厙 : 厂 車
厝 : ｜ 二 厂 日
厡 : 厂 日 水 白
厤 : ノ 厂 木 禾
厪 : 二 十 厂 口 廾 革
厫 : 厂 土 士 攵 方
厯 : 厂 心 木
厲 : 冂 厂 厶 ⺾ 田 ⽱
厴 : ｜ 丶 大 日 月 犬 田
厵 : 厂 小 日 白
厷 : 一 ノ 厶
厸 : 厶
厺 : 厶 大
厽 : 厶
叀 : 一 ｜ 十 厶 日 田
叅 : 丶 ノ 亅 ㅅ 厶 ⺣
叏 : ｜ 十 又 ユ 支
叒 : 又
叓 : ｜ 十 又 口 支
叕 : 丶 ノ 又
叚 : 一 ｜ 二 又 口
叝 : 卩 厶 又 土
叞 : 二 又 小 尸 示
叠 : 一 冖 又 宀 目
另 : 力 口
叧 : 刀 口
叵 : 匚 口
吂 : 一 丶 亠 匚 口
吓 : 一 卜 口
吚 : ノ 口 ヨ
吡 : 匕 口 比
吧 : 乙 口 已 巴
吨 : ノ 乙 凵 口 屯
吪 : ノ 乙 ⺅ 匕 口
启 : 丶 口 尸
吱 : 十 又 口 支
吴 : 一 口 大
吵 : ノ 口 小
呃 : 卩 厂 口
呄 : 十 乃 口
呇 : 口 水
呍 : 二 厶 口
呏 : ノ 口 廾
呞 : 一 亅 口
呢 : 匕 口 尸
呤 : 丶 ㅅ マ 口
呦 : 力 口 幺
呧 : 丶 口 氏
呩 : 二 口 小 示
呫 : 卜 口
呭 : 一 ｜ 口 世
呮 : ハ 口
呴 : 勹 口
呿 : 厶 口 土
咁 : 口 甘
咃 : ｜ 乙 ⺅ 匕 口 也
咅 : 口 立
咈 : ｜ ノ 口 廾 弓
咉 : 口 大
咍 : 厶 口
咑 : 一 亅 口 心
咕 : 十 口
咖 : 力 口
咜 : 匕 口 宀
咟 : 一 口 日 白
咡 : 口 耳
咦 : 口 大 弓
咧 : ⺉ 口 歹
咩 : 丷 口 王 羊
咪 : 口 米
咭 : 口 士
咮 : 一 ノ 口 木
咱 : 口 目 自
咷 : 丶 ノ 儿 冫 口
咹 : 口 女 宀
咺 : 一 口 日
咻 : ⺅ 口 木
咿 : ノ ⺅ 口 ヨ
哆 : 口 夕
哊 : 一 ノ 口 月 肉
响 : ノ 冂 口
哎 : 丶 ノ 口 ⺾
哠 : ノ 口 土
哪 : 二 刀 口 ⻏
哬 : 一 亅 ⺅ 口
哯 : 儿 口 目 見
哶 : 一 ｜ 二 十 卜 口 干
哼 : 一 亅 亠 口
哾 : 儿 丷 口
哿 : 一 亅 力 口
唀 : ノ 乃 口 木 禾
唁 : 口 言
唅 : 一 丶 ㅅ 口
唈 : 乙 口 已 ⻏ 巴
唉 : 一 ノ 厶 口 大 矢
唌 : ノ 口 廴 止
唍 : 二 儿 口 宀 元
唎 : ノ ⺉ 口 木 禾
唕 : 十 口 日 白
唪 : 一 ｜ 丶 ノ 二 口 大
唫 : 一 ㅅ 丷 十 口 土 干
唲 : 儿 口 臼
唵 : 乙 口 大 日 田 奄
唶 : ｜ 二 口 日
唻 : 人 口 木
唼 : 口 女 立
唽 : 口 斤 木
啁 : ｜ 二 冂 口 土
啇 : 亠 丷 冂 十 口
啉 : 口 木
啊 : 一 亅 口 ⻏ ⻖
啍 : 亠 口 子
啐 : 亠 人 十 口
啑 : 口 土 ヨ 走
啘 : 卩 口 夕 宀
啚 : 十 口 囗
啛 : 一 ｜ 十 口 女 ヨ
啞 : 一 ｜ 口
啠 : 口 斤
啡 : 口 非
啤 : ノ 十 口 日 白
啦 : 口 心 立
啿 : 一 ｜ ハ 匚 口 甘
喁 : 冂 厶 口 田 ⽱
喂 : 一 口 田 衣
喆 : 口 士
喈 : 匕 口 日 比 白
喎 : ｜ 冂 口
喏 : 口 ⺾ 石
喑 : 口 日 立 音
喒 : 卜 口 夂 日
喓 : 口 女 西
喔 : 一 厶 口 土 尸 至
喗 : 冖 口 車
喣 : 勹 口 ⺣
喤 : 口 日 王 白
喭 : 丶 ノ 亠 厂 口 彡
喲 : 一 丶 勹 口 小 幺 糸
喿 : 口 木
嗁 : 几 匕 卜 厂 口 虍
嗃 : 亠 冂 口 高
嗆 : 一 丶 ノ ㅅ 口 尸 日
嗉 : 一 ｜ 二 口 小 幺 糸
嗋 : 力 口 月
嗌 : 一 ハ 丷 口 皿
嗎 : 口 馬
嗑 : 厶 口 土 皿
嗒 : 一 ㅅ 口 ⺾
嗓 : 又 口 木
嗗 : 冂 冖 口 月 骨
嗘 : 口 大 幺 爪
嗛 : 一 ｜ 丶 ノ 口 ヨ
嗞 : 一 丷 口 幺
嗢 : 人 口 日 皿
嗩 : ハ 口 小 ⺌ 目 貝
嗶 : 一 ｜ 口 田 里
嗿 : 丶 ㅅ ハ 口 目 貝
嘅 : 乙 匕 厶 口 无 日 白 牙
嘈 : 一 ｜ 口 日
嘊 : 厂 口 土 山
嘍 : 一 ｜ 口 女 日
嘎 : 一 口 戈 目 自
嘏 : 二 十 又 口 尸
嘐 : ㅅ 冫 口 彡 羽
嘑 : 一 ノ 亅 丷 匕 卜 厂 口 虍
嘒 : 一 ｜ 二 口 ヨ
嘙 : 冫 十 厂 又 口 女 ⺡ 支
嘬 : 又 口 日 耳
嘰 : 人 口 幺 戈
嘳 : 一 ｜ ハ 口 目 虫 貝
嘵 : 一 儿 口 土
嘷 : 二 冫 十 口 目 自
嘹 : 丶 ノ 口 大 小 日
嘻 : 一 丷 十 口 士 豆
嘼 : 一 口 田
嘽 : 一 ｜ 十 口 日 田
嘿 : ｜ 二 丷 口 ⺣ 里 黒
噀 : ｜ 二 ハ 口 已
噁 : 一 ｜ 二 口 心
噃 : ノ 口 田 米
噄 : 一 ｜ 二 刀 口 小 幺 糸
噆 : 口 无 日 曰
噉 : 一 ｜ 口 攵 耳
噋 : 亠 口 子 攵
噍 : 口 ⺣ 隹
噏 : 一 ㅅ 冫 口 羽
噔 : 一 丷 口 癶 豆
噞 : 一 人 ㅅ 口
噠 : 丷 ⻌ 口 土 王 羊
噡 : ハ 勹 厂 口 言
噢 : ノ 冂 口 大 米
噣 : 勹 口 ⺲ 虫
噦 : 一 ｜ ノ 厂 口 戈 止
噩 : 口 王
噭 : 口 攵 方 日 白
噯 : 冖 口 夂 心 爪
噱 : 匕 卜 厂 口 虍 豕
噲 : 一 ｜ ㅅ 丷 口 日
噵 : 丷 ⻌ 口 目 自 首
嚄 : 又 口 ⺾ 隹
嚅 : 一 ｜ 冖 口 而 雨
嚈 : 丶 厂 口 大 日 月 犬
嚋 : 一 口 士 寸 工
嚌 : 一 亠 刀 口 廾 氏 齊
嚕 : 口 日 ⺣ 田 魚
嚙 : 一 人 凵 口 止
嚚 : 匚 口 臣
嚝 : 一 ｜ 二 ハ 口 广 日 田 黄
嚞 : 口 士
嚟 : ノ ㅅ 勹 口 木 水 禾
嚦 : ノ 厂 口 木 止 禾
嚧 : 匕 卜 厂 口 田 皿 虍
嚨 : 一 乙 口 月 立 竜
嚩 : 一 ｜ 丶 十 口 寸 小 幺 用 糸
嚫 : 一 儿 口 小 目 立 見
嚬 : ノ 亅 ハ 口 小 止 目 貝 頁
嚭 : 一 ｜ 丶 ノ 丷 十 口 士 豆
嚱 : 丷 匕 卜 厂 口 戈 虍 豆
嚳 : 一 ｜ ノ 冖 口 土 ヨ 爻 牛 臼
嚷 : 一 ｜ 二 亠 口 衣
嚾 : 口 ⺾ 隹
囅 : ｜ 二 十 口 尸 日 田 衣
囉 : 丶 ノ 口 小 幺 ⺲ 糸 隹
囊 : 一 ｜ 二 冖 十 口 衣
囋 : ノ 儿 ハ 口 土 目 貝
囏 : 一 ｜ 二 丷 十 口 士 大 豆 革
囐 : 丶 儿 冂 匕 卜 厂 口 大 犬 虍 鬲
囌 : ノ 口 ⺾ 木 ⺣ 田 禾 魚
囍 : 一 丶 ノ 丷 十 口 士 豆
囙 : 一 囗
囜 : 厶 囗
囝 : 囗 子
囟 : 丶 ノ 囗
囡 : 囗 女
囤 : ノ 乙 凵 囗 屯
囥 : 一 丶 亠 几 囗
囦 : 囗 水
囧 : ハ 口 囗
囨 : 一 ｜ ノ 囗
囱 : 丶 ノ 囗 夂
囫 : ノ 勹 囗 勿
园 : 二 儿 囗 元
囶 : ハ 囗 土
囷 : ノ 囗 木 禾
圁 : 囗 言
圂 : 囗 豕
圇 : 一 ｜ 亅 ㅅ 冂 囗 冊 廾
圊 : 一 ｜ 二 亠 冂 囗 土 月 青
圌 : 囗 山 而
圑 : 一 ｜ 丶 二 冂 囗 寸 巾
圕 : ｜ 二 囗 ヨ 日 聿
圚 : 一 ｜ ハ 口 囗 目 虫 貝
圛 : 一 ｜ 丷 十 土 干 ⺲
圝 : 囗 小 幺 糸 言
圠 : 乙 土
圢 : 一 亅 土
圣 : 又 土
圤 : 卜 土
圥 : 儿 土
圩 : 亅 二 土
圪 : 一 ノ 乙 土
圬 : 二 勹 土
圮 : 土 已
圯 : 土 已
圳 : 土 川
圴 : 一 丶 勹 土
圽 : ノ 勹 土 勿
圾 : 丶 又 乃 土 及
圿 : ｜ ノ ㅅ 土
坅 : 一 丶 ㅅ 土
坆 : 土 攵
坌 : ハ 刀 土
坍 : 一 丶 冂 土 舟
坒 : 匕 土 比
坢 : ｜ 二 丷 土
坥 : 一 土 目
坧 : 一 ノ 口 土 石
坨 : 匕 土 宀
坫 : 卜 口 土
坭 : 匕 土 尸
坮 : 厶 口 土
坯 : 一 ｜ 丶 ノ 土
坰 : 冂 口 土
坱 : 土 大
坳 : 力 土 幺
坴 : 儿 ハ 土
坵 : 一 土 斤
坷 : 一 亅 口 土
坹 : ハ 土 宀 穴
坺 : 又 土 弋
坻 : 一 丶 土 氏
坼 : 丶 土 斤
坾 : 一 亅 土 宀
垁 : 一 ノ 土 大 矢
垃 : 土 立
垌 : 一 冂 口 土
垔 : 土 西
垗 : 丶 ノ 儿 ハ 冫 土
垙 : 一 儿 土 ⺌
垚 : 土
垜 : 乃 土 木
垝 : ノ 勹 卩 厂 土
垞 : 一 ノ 乙 匕 土 宀
垟 : 丷 土 王 羊
垡 : 丶 乙 ⺅ 土 戈
垕 : 一 ノ 厂 口 土
垧 : ノ 冂 口 土
垨 : 土 宀 寸
垩 : ｜ 丶 ノ 二 丷 土
垬 : ｜ 二 ハ 土
垸 : 一 二 儿 土 宀 元
垽 : 土 ⺡ 斤
埇 : マ 土 用
埈 : 儿 厶 土 夂
埌 : 丶 土 艮
埏 : ノ 土 廴 止
埕 : ｜ ノ 二 口 土 王
埝 : 丶 ㅅ 土 心
埞 : 土 宀 疋
埤 : ノ 十 土 日
埦 : 卩 土 夕 宀
埧 : 一 ハ 土 目 貝
埩 : 亅 勹 土 ヨ
埭 : 土 ヨ 水 隶
埰 : 土 木 爪
埵 : 一 ノ 土 車
埶 : 丶 儿 ハ 九 土
埸 : ノ 勹 土 日 勿
埽 : ｜ 冂 冖 土 巾 ヨ
埾 : 又 土 耳
埿 : 匕 土 尸 ⺡
堃 : 土 方
堄 : 儿 土 臼
堈 : 一 丷 冂 土 山 岡
堉 : 亠 厶 土 月
埡 : 一 ｜ 土
堌 : 十 口 囗 土
堍 : 一 ｜ 丶 ノ 乙 儿 勹 口 土 免
堛 : 一 口 土 田
堞 : 一 ｜ 土 木 世
堟 : 土 ヨ 彑 豕
堠 : 一 ノ ⺅ ユ 土 大 矢
堦 : 匕 土 日 比 白
堧 : 土 大 而
堭 : 土 日 王 白
堲 : 匕 卩 厶 土 日 白
堹 : 一 ｜ ノ 土 日 車
堿 : 一 ノ 厂 口 土 戈
塉 : 丶 ノ 二 人 冫 土 月
塌 : ノ 亅 冫 土 日 羽
塍 : 一 丶 ハ 丷 冂 土 大 月
塏 : 丷 口 土 山 豆
塐 : 一 ｜ 二 土 小 幺 糸
塕 : ㅅ ハ 冫 厶 土 羽
塟 : 一 匕 土 夕 ⺾ 歹
塡 : ハ 匕 土 目 貝
塤 : ハ 口 土 目 貝
塧 : 一 ハ 丷 土 皿
塨 : ｜ 丶 ノ 亅 二 土 ⺣
塸 : 匚 口 土
塼 : 丶 厶 土 寸 日 車
塿 : ｜ 口 土 女 日
墀 : ｜ 丶 ノ 二 冫 土 尸 牛
墁 : 二 冂 又 土 日 ⺲
墇 : 十 土 日 曰 立
墈 : 一 ｜ 二 ハ 力 匚 土 甘
墉 : ｜ 土 广 ヨ 月 用
墊 : 一 丶 丷 十 九 土
墌 : 一 ｜ 土 广 ⺣
墍 : 乙 匕 土 无 日 白 牙
墏 : 丶 土 夕 寸 爿
墐 : 二 十 口 土 革
墔 : 土 山 隹
墖 : 一 ㅅ 口 土 田
墝 : 一 儿 土
墠 : 一 ｜ 十 口 土 日 田
墡 : 一 丷 口 土 王 羊
墢 : 几 又 土 弓 殳 癶
墦 : ノ 土 田 米
墩 : 亠 口 土 子 攵
墱 : 丷 口 土 癶 豆
墲 : 一 ｜ ノ 土 ⺣ 無
壄 : マ 土 木 矛
墼 : 几 凵 又 土 山 殳 車
壂 : ｜ 二 ハ 几 又 土 尸 殳
壈 : ノ 亠 口 囗 土 木 禾
壍 : 土 ⺡ 斤 車
壎 : 一 ｜ ノ 二 丷 口 土 ⺣ 車
壐 : 一 ｜ 丶 ノ ハ 冂 土 巾 爻
壒 : 厶 土 ⺾ 皿
壔 : 一 口 土 士 寸 工
壖 : 一 ｜ 冖 土 而 雨
壚 : 匕 卜 厂 土 田 皿 虍
壝 : ハ 土 目 虫 貝
壡 : 一 ㅅ ハ 冖 卜 又 口 土 谷
壢 : ノ 厂 土 木 止 禾
壩 : 一 ｜ 二 冖 十 口 土 廾 月 雨 革
壳 : 一 冖 几 士
夅 : ｜ 二 土 夂
夆 : 一 ｜ 二 夂
夋 : 儿 ハ 厶 夂
夌 : 儿 ハ 土 夂
夒 : 一 ハ 夂 已 止 目 自 貝 頁
夓 : 一 ハ 夂 ヨ 目 自 臼 貝 頁
夔 : 一 儿 ハ 丷 夂 已 止 目 自 見 首
虁 : 一 ｜ 儿 ハ 丷 卜 夂 已 ⺾ 止 目 自 見 首
夝 : 夕 生
夡 : 口 士 夕
夣 : 亠 冖 厶 夕 ⺲
夤 : 一 ｜ ハ 夕 宀 田
夨 : 大
夯 : 力 大
夰 : ｜ ノ 大
夳 : 二 大
夵 : 大 小
夶 : 大
夿 : 乙 大 已 巴
奃 : 丶 大 氏
奆 : 匚 口 大
奒 : 亠 大 幺 玄
奓 : 夕 大
奙 : 乙 厶 大 日 奄
奛 : 大 日 月
奝 : ｜ 二 冂 口 土 大
奞 : 大 隹
奟 : 丶 冂 大 月
奡 : 一 ｜ ノ 大 目 自
奣 : 一 大 日 月
奫 : 一 大 ⺡ 爿 片
奭 : 一 大 日 白
奯 : 一 ｜ ノ 厂 大 戈 止
奲 : ノ 十 口 土 大 ⺹ 日 田
奵 : 一 亅 女
奶 : 乃 女
她 : ｜ 乙 匕 女 也
奻 : 女
奼 : 一 ノ 乙 匕 女
妋 : 一 ノ 二 大 女 无
妌 : 一 二 女 廾
妎 : ｜ ノ ㅅ 女
妒 : 一 丶 ノ 女 尸 戸
妕 : ｜ 口 女
妗 : 一 丶 ㅅ 女
妟 : 女 日
妤 : 一 亅 マ 女 矛
妧 : 二 儿 女
妭 : 又 女 弋
妮 : 匕 女 尸
妯 : ｜ 女 日 田
妰 : 一 ｜ ノ 二 女
妳 : 一 ノ 亅 ハ 勹 女 小
妷 : 一 ノ 大 女
妺 : 一 女 木
妼 : ノ 女 心
姁 : 勹 口 女
姃 : 一 女 止
姄 : 女 尸 氏
姈 : 一 ｜ 丶 亅 ㅅ マ 女
姊 : ｜ ノ 亅 女 牙
姍 : 一 ｜ 亅 冂 女 冊 廾
姒 : 丶 ノ 女
姝 : 一 ノ 木
姞 : 口 士 女
姟 : 亠 女 幺 玄
姣 : 亠 女 父
姤 : 一 ノ 口 女
姧 : 一 十 女 干
姮 : 一 女 日
姯 : 一 儿 女 ⺌
姱 : 二 勹 大 女
姲 : 女 宀
姴 : ⺉ 女 歹
姷 : 一 ノ 女 月
娀 : 一 ノ 女 戈
娄 : 女 米
娌 : 女 里
娍 : ノ 亅 厂 女 戈
娎 : 女 心 斤
娒 : 一 ノ 女 毋 母
娓 : 女 尸 毛
娞 : 女 爪
娣 : ｜ ノ 丷 女 弓
娤 : 士 女 爿
娧 : 儿 ハ 丷 口 女
娨 : 一 十 女 干 日
娪 : 一 二 口 女 五
娭 : 一 ノ 厶 大 女 矢
娰 : 丶 ノ ⺅ 女
婄 : 口 女 立
婅 : 勹 女 米
婇 : 女 木 爪
婈 : ハ 土 夂 女
婌 : 一 卜 又 女 小
婐 : 女 日 木 田
婕 : 土 女 ヨ 走
婞 : 一 丷 十 土 女 干
婣 : 女 爿 片
婥 : 十 卜 女 日
婧 : 二 亠 土 女 月 青
婭 : 一 ｜ 女
婷 : 一 亅 亠 冖 口 女
婺 : マ 女 攵 矛
婻 : 一 丷 冂 十 女 干
婾 : 一 丶 ノ 人 冂 女 月
媋 : 一 二 大 女 日
媐 : 匚 女 已 臣
媓 : 女 日 王 白
媖 : 大 女 ⺾
媙 : 一 ノ 厂 女 戈
媜 : ハ 卜 女 目 貝
媞 : 女 日 疋
媟 : 一 ｜ 女 木 世
媠 : 一 ノ 女 工 月
媢 : 二 冂 女 目
媧 : 冂 口 女
媬 : ⺅ 口 女 木
媱 : 丶 凵 夕 女 山 爪 缶
媲 : 丶 ノ 匕 口 女 比
媳 : 女 心 目 自
媵 : 一 丶 ハ 丷 冂 大 女 月
媸 : 一 女 屮 山 虫
媺 : 一 儿 几 女 山 攵
媻 : 一 ｜ 丶 冂 几 又 女 殳 舟
媿 : 儿 匕 厶 女 田 鬼
嫄 : 厂 女 小 日 白
嫆 : ㅅ ハ 口 女 宀 谷
嫈 : 冖 女 火
嫏 : 丶 厶 女 ⻏ 日
嫚 : 又 女 日 ⺲
嫜 : 十 女 日 立 音
嫠 : 一 厂 女 攵 木
嫥 : 一 ｜ 十 厶 女 寸 日 虫
嫪 : ノ ㅅ 冫 女 彡 羽
嫮 : 一 ｜ 二 冂 勹 女 雨
嫵 : 一 ｜ ノ 女 ⺣ 無
嫶 : 女 ⺣ 隹
嫽 : 丶 ノ 大 女 小 日 曰
嬀 : ノ 亅 女 ⺣ 爪
嬁 : 丷 口 女 癶 豆
嬈 : 一 儿 土 女
嬗 : 一 亠 口 囗 女 日
嬴 : 一 丶 亠 几 口 女 亡 月
嬙 : 人 口 囗 土 女
嬛 : 一 口 女 ⺲ 衣
嬝 : 一 ｜ 亅 亠 女 日 白 衣 鳥
嬡 : 冖 夂 女 心 爪
嬥 : ノ 冫 女 羽 隹
嬭 : 一 ｜ ハ 冂 女 爻
嬸 : ノ 女 宀 田 米
孁 : 一 ｜ 二 冖 口 女 雨
孋 : 一 丶 冂 匕 女 广 比 鹿
孌 : 女 小 幺 糸 言
孒 : 一 亅 子
孖 : 子
孞 : 子 心
孨 : 子
孮 : 二 子 宀 小 示
孯 : 匚 又 子 臣
孼 : ｜ ノ 十 口 子 屮 立 辛
孽 : ｜ ノ 十 口 子 ⺾ 立 辛
孾 : ハ 女 子 目 貝
孿 : 子 小 幺 糸 言
宁 : 一 亅 宀
宄 : 九 宀
宆 : 宀 弓
宊 : 丶 大 宀 犬
宎 : ノ 大 宀
宐 : 一 丶 勹 宀 ヨ 彑
宑 : 一 宀 廾
宓 : ノ 宀 心
宔 : 丶 宀 王
宖 : 厶 宀 弓
宨 : 丶 ノ 儿 冫 宀
宩 : 宀 米
宬 : ノ 亅 厂 宀 戈
宭 : ノ 口 宀 ヨ
宯 : ノ 土 子 宀 ⺹
宱 : 一 ｜ ノ ⺅ 宀
宲 : 口 宀 木
宷 : ノ 宀 米
宺 : ｜ 儿 口 宀 川
宼 : 二 儿 女 宀
寀 : 宀 木 爪
寁 : 土 宀 ヨ 走
寍 : 宀 心 皿
寏 : ハ 勹 口 大 宀
寖 : 冖 又 宀 ヨ ⺡
寗 : 一 ｜ ノ 宀 心 月
寘 : 一 ハ 冂 匕 十 目 貝 頁
寙 : 厶 宀 瓜
寚 : 凵 宀 山 王 缶
寠 : 一 ｜ 口 女 宀 日
寯 : ｜ 亅 宀 隹
寱 : 宀 木 爿 目 自
寴 : 一 儿 宀 小 目 立
寽 : 寸 爪
尌 : 丷 十 口 士 寸 豆
尗 : 一 卜 小
尞 : 丶 ノ 大 小 日
尟 : 一 ノ 小 日 止 疋
尣 : 儿 ハ
尦 : 丶 儿 ハ 勹
尩 : 儿 ハ 王
尫 : 一 儿 王
尬 : 一 ｜ ノ 乙 ㅅ
尮 : 一 ノ 乙 乃 木
尰 : 一 ｜ ノ 乙 二 日 車
尲 : 一 ｜ 丶 ノ 乙 丷 ヨ
尵 : 一 ノ 乙 ハ 目 虫 貝
尶 : 一 丶 ノ 乙 匚 皿 臣
屙 : 一 亅 口 尸 ⻖
屚 : 尸 雨
屜 : 一 ｜ 尸 彳 世
屢 : 一 口 女 尸 日
屣 : 尸 彳 止
屧 : 一 ｜ 尸 彳 木 世
屨 : 一 ｜ 口 女 尸 彳 日
屩 : ノ 冂 口 大 尸 彳
屭 : ハ 尸 目 貝
屰 : 一 丷 屮
屴 : 力 山
屵 : 厂 山
屺 : 山 已
屻 : ノ 刀 山
屼 : 一 儿 山
屽 : 一 十 山 干
岇 : ノ 卩 山
岈 : 山 牙
岊 : 乙 山 已 巴
岏 : 二 儿 山 元
岒 : 丶 人 山
岝 : 一 ｜ ノ 二 山
岟 : 大 山
岠 : 匚 口 山
岢 : 一 亅 口 山
岣 : 勹 口 山
岦 : 山 立
岪 : 山 廾 弓
岲 : 儿 口 山
岴 : 一 山 斤
岵 : 十 口 山
岺 : 一 ｜ 丶 亅 人 マ 山
峉 : 口 夂 山
峋 : 勹 山 日
峒 : 一 冂 口 山
峝 : 一 冂 口 山
峗 : 勹 卩 厂 山
峮 : ノ 口 山 ヨ
峱 : 一 ユ 山 ⺨
峲 : ノ ⺉ 山 木 禾
峴 : 儿 山 目 見
崁 : 人 勹 土 山 欠
崆 : 儿 ハ 宀 山 工
崍 : 人 大 山
崒 : 亠 人 十 山
崫 : ｜ 凵 尸 山
崣 : ノ 女 山 木 禾
崤 : 一 丶 ノ 山 月
崦 : 乙 大 山 日 奄
崧 : 儿 厶 山 木
崱 : ハ ⺉ 山 目 貝
崴 : 一 ノ 厂 女 山 戈
崹 : ｜ 亠 丷 冂 冖 山 巾
崽 : 山 心 田
崿 : 二 勹 口 山
嵂 : ｜ 二 山 ヨ 彳 聿
嵃 : 丶 ノ 亠 厂 山 彡 立
嵆 : 丶 ノ 尢 山 木 尤 禾
嵈 : ノ 二 又 山 爪
嵕 : 丶 ノ ハ 凵 夂 山
嵑 : 一 人 勹 山 日 曰
嵙 : ノ 山 斗 木 禾
嵊 : 一 ｜ ノ 匕 山 木 禾
嵟 : 厂 山 隹
嵠 : 大 山 幺 爪
嵡 : ノ ハ 冫 厶 山 羽
嵢 : 丶 ノ ㅅ 口 山 日
嵤 : 冖 山 火
嵪 : 亠 冂 口 山 高
嵭 : 亠 丷 冖 山 方
嵰 : ｜ 丶 ノ 丷 山 ヨ
嵹 : 口 山 弓 虫
嵺 : ㅅ 冫 山 彡 羽
嵾 : 人 厶 山 彡
嵿 : 一 亅 ハ 山 目 貝 頁
嶁 : 一 ｜ 口 女 山 日
嶃 : 山 斤 車
嶈 : 丶 夕 寸 山 爿
嶊 : 山 心 隹
嶒 : ｜ ハ 丷 口 山 日
嶓 : ノ 山 田 米
嶔 : 人 勹 山 欠 金
嶕 : 山 ⺣ 隹
嶙 : 夕 山 米 舛
嶛 : 丶 ノ 大 小 山 日 曰
嶟 : 丷 寸 山 酉
嶠 : ノ 冂 口 大 山
嶧 : 一 丷 十 土 山 干 ⺲
嶫 : 一 ｜ 丶 ノ 丷 山 木 王 羊
嶰 : ｜ 刀 勹 山 月 牛 角
嶴 : ノ 冂 大 山 米
嶸 : 冖 山 木 火
嶹 : 一 口 士 寸 山 工
巃 : 一 乙 山 月 田 立 竜
巇 : 丷 匕 卜 厂 口 山 戈 虍 豆
巋 : ｜ ノ 冂 冖 口 山 巾 ヨ 止
巐 : ノ 亠 冂 口 山 廾 日
巎 : 一 ハ 夂 山 已 止 目 自 貝 頁
巘 : 一 丶 儿 冂 匕 卜 厂 口 尢 山 尤 虍 鬲
巙 : 一 ハ 丷 夂 山 已 止 目 自 首
巠 : 一 巛 工
巤 : 丶 ノ 乙 口 川 巛
巩 : 一 丶 乙 几 工
巸 : ｜ 匚 口 已 臣
巹 : 一 已 水
帀 : 一 ｜ 冂 巾
帇 : ｜ 冂 巾 ヨ
帍 : ｜ 丶 冂 尸 巾
帒 : ｜ ⺅ 冂 巾 弋
帔 : ｜ ノ 冂 十 又 巾 支
帕 : ｜ 冂 巾 日 白
帘 : ｜ 儿 ハ 冂 宀 巾
帟 : ｜ 丶 ノ 亅 亠 ハ 冂 巾
帠 : ｜ 冂 巾 ヨ 臼
帮 : 一 ｜ ノ 二 冂 巾 ⻏
帨 : ｜ 儿 ハ 丷 冂 口 巾
帲 : 一 ｜ ノ 冂 十 巾 干
帵 : ｜ 冂 卩 夕 宀 巾
帾 : ｜ ノ 冂 土 巾 ⺹ 日
幋 : 一 ｜ 丶 冂 几 又 巾 殳 舟
幐 : 一 ｜ 丷 冂 大 巾 月
幉 : 一 ｜ 冂 巾 木 世
幑 : ｜ ノ 冂 山 巾 彳 攵
幖 : ｜ 二 冂 小 巾 示 西
幘 : 一 ｜ 二 ハ 冂 土 巾 目 貝
幛 : ｜ 冂 十 巾 日 立
幜 : ｜ 亠 冂 口 小 巾 日 曰
幞 : 一 ｜ 丶 ノ 二 丷 冂 大 巾 王 羊
幨 : ｜ 儿 ハ 冂 勹 厂 巾 言
幪 : 一 ｜ 冂 冖 巾 ⺾ 豕
幫 : ｜ 冂 土 寸 巾 日 白
幬 : 一 ｜ 冂 口 士 寸 工 巾
幭 : ｜ 人 冂 巾 ⺾ 戈 ⺲
幮 : ｜ 丷 冂 十 口 士 寸 巾 广 豆
幰 : 一 ｜ 二 冂 宀 巾 心 ⺲
庀 : 匕 广
庋 : 十 又 广 支
庎 : ｜ ノ ㅅ 广
庢 : 一 厶 土 广 至
庤 : 土 寸 广
庥 : ⺅ 广 木
庨 : ノ 土 子 广 ⺹
庪 : 十 又 广 心 支
庬 : 丶 尢 广 彡 尤
庱 : ハ 土 夂 广
庳 : ノ 十 广 日 白
庽 : ｜ 冂 厶 广 田 虫
庾 : 人 广 臼
庿 : 广 ⺾ 田
廆 : 儿 匕 厶 广 田 鬼
廌 : 一 ｜ 勹 广 ⺣
廋 : 十 又 广 支 臼
廎 : ハ 匕 卜 广 目 貝 頁
廑 : 二 十 口 广 廾 革
廒 : 土 广 攵 方
廔 : 一 ｜ 口 女 广 日
廕 : 一 丶 ㅅ 厶 ユ 广 ⻖
廜 : ノ 土 尸 广 ⺹ 日 曰
廞 : 人 勹 广 欠 金
廥 : 一 ｜ 丶 ノ ㅅ 丷 口 广 日 曰
廫 : 人 冫 广 彡 月 羽
异 : 已 廾
弆 : 厶 土 廾
弇 : 一 ㅅ 口 廾
弈 : 丶 ノ 亠 儿 ハ 廾
弎 : 一 二 弋
弙 : 亅 二 弓
弜 : 弓
弝 : ｜ 已 弓
弡 : 匚 口 弓
弢 : 又 屮 山 弓 支
弣 : ⺅ 寸 弓
弤 : 丶 弓 氏
弨 : 刀 口 弓
弫 : 匚 弓 臣
弬 : 匚 弓 臣
弮 : 一 丷 大 弓
弰 : ⺌ 弓 月
弴 : 亠 口 子 弓
弶 : 亠 口 小 弓
弻 : 一 人 弓 西
弽 : 一 ｜ 弓 木 世
弿 : 一 ｜ 二 ハ 宀 弓
彀 : 一 冖 几 又 士 弓 殳
彄 : 匚 口 弓
彅 : 一 丷 刀 ⺉ 弓 月
彇 : ｜ 弓 ヨ 爿 片
彍 : 一 ｜ 二 ハ 宀 弓 田
彐 : ヨ
彔 : ヨ 彑 水
彘 : 一 ノ 匕 大 ヨ 彑 矢
彛 : ハ 刀 廾 ヨ 米
彠 : 又 口 寸 工 ヨ ⺾ 隹
彣 : 彡 文
彤 : 一 丶 冂 彡 舟
彧 : 一 口 弋 彡
彯 : 二 小 彡 示 西
彲 : 一 丶 冂 匕 广 彡 比 鹿
彴 : 丶 勹 彳
彵 : ｜ 乙 匕 彳 也
彸 : ハ 厶 彳
彺 : 彳 王
彽 : 一 丶 彳 氏
彾 : 一 ｜ 丶 亅 ㅅ マ 彳
徉 : 丷 彳 王 羊
徍 : 土 彳
徏 : ノ 亅 小 彳 止
徖 : 二 宀 小 彳 示
徜 : 冂 口 小 ⺌ 彳
徝 : 一 十 彳 目
徢 : 土 ヨ 彳 走
徧 : 一 ｜ 丶 亅 冂 尸 彳 戸 冊 廾
徫 : 口 彳 韋
徤 : ｜ 二 廴 ヨ 彳 聿
徬 : 亠 冖 彳 方 立
徯 : 大 幺 彳 爪
徰 : 一 彳 止
徱 : 二 小 彳 示 西
徸 : 彳 立 里
忄 : ⺖
忇 : 力 ⺖
忈 : 二 心
忉 : 刀 ⺖
忋 : 已 ⺖
忐 : 一 卜 心
忑 : 一 卜 心
忒 : 弋 心
忓 : 一 十 干 ⺖
忔 : 一 ノ 乙 ⺖
忞 : 心 文
忡 : ｜ 口 ⺖
忢 : 一 二 心 五
忨 : 二 儿 ⺖ 元
忩 : ハ 厶 心
忪 : ハ 厶 ⺖
忬 : 一 亅 マ ⺖ 矛
忭 : 亠 卜 ⺖
忮 : 十 又 ⺖ 支
忯 : ⺖ 氏
忲 : 丶 大 ⺖
忳 : 一 ノ 乙 凵 ⺖ 屯
忶 : 二 厶 ⺖
忺 : 人 勹 ⺖ 欠
忼 : 亠 几 ⺖
怇 : 匚 口 ⺖
怊 : 刀 口 ⺖
怍 : 一 ｜ ノ 二 ⺖
怓 : 又 女 ⺖
怔 : 一 ⺖ 止
怗 : 卜 口 ⺖
怘 : 十 口 心
怚 : 一 ⺖ 目
怟 : 丶 ⺖ 氏
怤 : ⺅ 寸 心
怭 : ノ ⺖ 心
怳 : 儿 口 ⺖
怵 : 一 ｜ 丶 ノ 乙 ⺖ 木
恀 : 夕 ⺖
恇 : 匚 ⺖ 王
恈 : 厶 ⺖ 牛
恉 : 匕 ⺖ 日
恌 : 丶 ノ 儿 冫 ⺖
恑 : 勹 卩 厂 ⺖
恔 : 亠 ⺖ 父
恖 : 丶 ノ 口 心
恗 : 二 勹 大 ⺖
恝 : 一 ｜ 二 刀 彡 心
恡 : 一 丶 ノ 厶 ⺖
恧 : 心 而
恱 : 儿 ハ 厶 ⺖
恾 : 亠 ⺖ ⺾ 亡
恿 : マ 心 用
悂 : 匕 土 ⺖ 比
悆 : 二 ㅅ 小 心 示
悈 : 廾 ⺖ 戈
悊 : 心 心 斤
悎 : ノ 口 土 ⺖
悑 : 一 ｜ 丶 二 冂 十 ⺖ 月 用
悓 : 儿 ⺖ 目 見
悕 : 一 ｜ 丶 ノ 冂 巾 ⺖
悘 : 一 ノ 匚 大 心 矢
悝 : ⺖ 里
悞 : 口 大 ⺖ 无
悢 : 丶 ⺖ 艮
悤 : ノ 口 夂 心
悥 : 二 亠 口 心 言
您 : ⺅ 冖 勹 小 心
悰 : 二 宀 小 ⺖ 示
悱 : ⺖ 非
悷 : 一 丶 大 尸 ⺖ 戸 犬
悻 : 一 丷 十 土 干 ⺖
悾 : 儿 ハ 宀 工 ⺖ 穴
惂 : 勹 ⺖ 臼
惄 : 又 土 小 心
惈 : ⺖ 日 木 田
惉 : 卜 口 ⺡ 心
惊 : 亠 口 小 ⺖
惋 : 卩 夕 宀 ⺖
惎 : 一 ｜ 二 心
惏 : ⺖ 木
惔 : ⺖ 火
惕 : ノ 勹 ⺖ 日 勿
惙 : 又 ⺖
惛 : ⺖ 日 氏
惝 : 冂 口 小 ⺌ ⺖
惞 : 人 勹 ⺖ 斤 欠
惢 : 心
惥 : 人 大 心 臼
惲 : 冖 ⺖ 車
惵 : 一 ｜ ⺖ 木 世
惸 : 勹 子 ⺖ 日
惼 : 一 ｜ 亅 冂 尸 ⺖ 戸 冊 廾
惽 : 一 乙 尸 ⺖ 日 氏
愂 : 冖 力 十 子 心
愇 : 口 ⺖ 韋
愊 : 一 口 ⺖ 田
愌 : ハ 冂 勹 大 ⺖
愐 : ⺖ 面
愑 : ｜ 力 マ ⺖ 月 用
愒 : 人 勹 ⺖ 日
愓 : 一 ノ 勹 ⺖ 日 勿
愔 : ⺖ 日 立
愖 : 一 ｜ 儿 ハ 匚 ⺖ 甘 目
愗 : マ 心 攵 矛
愙 : 口 夂 宀 心
愜 : 人 匚 大 ⺖
愞 : 大 ⺖ 而
愢 : ⺖ 心 田
愪 : ハ 口 ⺖ 目 貝
愫 : 一 ｜ 二 亠 土 小 幺 ⺖ 糸
愰 : 一 儿 ⺌ ⺖ 日
愱 : 一 ノ 大 ⺖ ⽧ 矢
愵 : 丶 冫 弓 ⺖
愶 : 力 ⺖ 月
愷 : 丷 口 山 ⺖ 豆
愹 : ㅅ ハ 口 宀 ⺖ 谷
慁 : 口 心 豕
慅 : 丶 又 ⺖ 虫
慆 : ⺖ 爪 臼
慉 : 亠 幺 ⺖ 玄 田
慞 : 十 ⺖ 日 立
慠 : 土 士 ⺖ 攵 方
慬 : 二 十 口 廾 ⺖ 革
慲 : 一 ｜ 人 冂 巾 ⺖
慸 : 一 ｜ ノ 乙 冂 冖 凵 巾 廾 心
慻 : 一 ハ 丷 大 ⺖ 目
慼 : 一 ノ 卜 厂 小 心 戈
慿 : 冫 廾 心 馬
憀 : ㅅ 冫 彡 ⺖ 羽
憁 : ノ 口 夂 ⺖ 心
憃 : 一 二 大 心 臼
憄 : 十 彳 心 目
憋 : ｜ ハ 丷 冂 巾 心 攵
憍 : ノ 冂 口 大 ⺖
憒 : 一 ｜ ハ 口 ⺖ 目 虫 貝
憓 : 一 ｜ 厶 ⺖ 心 日 虫
憗 : 人 心 攵 木
憘 : 丷 十 口 士 ⺖ 豆
憜 : 一 ノ 工 ⺖ ⻖ 月
憝 : 亠 口 子 心 攵
憟 : ⺖ 米 西
憠 : 一 人 丷 勹 厂 屮 心 欠
憥 : 冖 力 心 火
憨 : 一 ｜ ユ 心 攵 耳
憪 : ⺖ 月 門
憭 : 丶 ノ 大 小 ⺖ 日
憸 : 一 人 ㅅ 口 ⺖
憹 : ｜ 厂 ⺖ 日 衣 辰
憼 : 勹 口 ⺾ 心 攵
懀 : 一 ｜ ㅅ 丷 口 ⺖ 日
懁 : 一 口 ⺖ ⺲ 衣
懂 : 一 ノ ⺖ ⺾ 車
懎 : 人 口 囗 土 ⺖
懏 : ｜ 亅 ⺖ 隹
懕 : 丶 厂 大 心 日 月 犬
懜 : 一 ｜ 冖 卜 夕 ⺖ ⺾ ⺲
懝 : 一 ノ 匕 マ 大 ⺖ 疋 矢
懞 : 一 冖 ⺖ ⺾ 豕
懟 : 一 ｜ 丶 ノ 丷 寸 心 王 羊
懡 : ノ 厶 广 ⺖ 木 麻
懢 : 一 丶 ノ 二 匚 ⺖ 皿 臣
懧 : 一 亅 宀 ⺖ 心 皿
懩 : 一 丶 二 丷 大 ⺖ 艮
懥 : 冖 十 厶 ⺖ 止 田 疋
懬 : ハ 广 心 田 黄
懭 : ハ 广 ⺖ 田 黄
懯 : 一 ｜ 丶 二 冂 心 攵 方 用 田
戁 : 十 口 大 廾 心 隹 革
戃 : ｜ 二 丷 冖 口 ⺌ ⺖ ⺣ 里 黒
戄 : 又 ⺖ 目 隹
戇 : ハ 十 夂 工 心 日 目 立 貝
戓 : 口 戈
戕 : 戈 爿
戜 : 口 戈 王
戠 : 亠 丷 戈 日 曰 立
戢 : 口 戈 耳
戣 : 一 大 戈 癶
戧 : 丶 ノ ㅅ 口 戈 日
戩 : 二 厶 戈 日
戫 : 一 ノ 口 戈 月
戹 : 一 丶 乙 尸 戸
戽 : 一 丶 尸 戸 斗
扂 : 丶 卜 口 尸
扃 : 一 丶 冂 口 尸 戸
扄 : 丶 ノ 冂 口 尸
扆 : 一 丶 亠 尸 戸 衣
扌 : 心
扐 : 力 心
扑 : 卜 心
扒 : ハ 心
扔 : 乃 心
扖 : 入 心
扚 : 一 丶 勹 心
扜 : 亅 二 心
扤 : 一 儿 心
扭 : ｜ ヨ 心
扯 : 心 止
扳 : ノ 厂 又 心
扺 : 心 氏
扽 : ノ 乙 凵 心 屯
抍 : ノ 廾 心
抎 : 二 厶 心
抏 : 二 儿 心 元
抐 : 人 入 冂 心
抦 : 一 人 冂 心
抨 : 一 ハ 丷 十 干 心
抳 : 匕 尸 心
抶 : 一 ノ 大 心
抷 : 一 ｜ 丶 ノ 心
抺 : 一 心 木
抾 : 厶 土 心
抿 : 一 乙 尸 心 氏
拄 : 丶 亠 土 心 王
拎 : 丶 ㅅ マ 心
拕 : 匕 宀 心
拖 : 一 ｜ ノ 乙 匕 心 也
拚 : 厶 廾 心
拪 : 心 西
拲 : ｜ ノ 二 手
拴 : ㅅ 心 王
拼 : 一 丷 廾 心
拽 : ノ 乙 心 日
挃 : 一 厶 土 心 至
挄 : 一 儿 ⺌ 心
挊 : 一 卜 心
挋 : 匚 心 臣
挍 : 亠 心 父
挐 : 口 女 手
挓 : 一 ノ 乙 宀 心
挖 : 乙 儿 ハ 宀 心
挘 : ノ 力 小 心
挩 : 儿 ハ 口 心
挪 : 一 刀 ヨ 心 ⻏
挭 : 一 丶 ノ 口 心 日
挵 : 廾 心 王
挶 : 亅 口 尸 心
挹 : 乙 口 已 心 ⻏ 巴
挼 : 女 心 爪
捁 : ｜ ノ 二 口 土 心
捂 : 一 二 口 心 五
捃 : ノ 口 ヨ 心
捄 : 一 丶 心 水
捆 : 口 囗 心 木
捊 : 子 心 爪
捋 : 寸 心 爪
捎 : 小 ⺌ 心 月
捒 : 口 心 木
捓 : 心 ⻏ 牙
捔 : 勹 心 用
捘 : ハ 厶 夂 心
捛 : 口 心
捥 : 卩 夕 宀 心
捦 : 心 金
捬 : ⺅ 寸 广 心
捭 : 一 ノ 十 口 心 日
捱 : 厂 土 心
捴 : ハ 厶 心 心
捵 : ｜ ハ 心 日
捸 : ヨ 心 水 隶
捼 : ノ 女 心 木 禾
捽 : 亠 人 十 心
捿 : 一 ｜ 女 ヨ 心
掂 : 卜 口 广 心
掄 : 一 ｜ 亅 ㅅ 冂 心 冊 廾
掇 : 又 心
掊 : 口 心 立
掐 : 勹 心 臼
掔 : 匚 又 手 臣
掕 : ハ 土 夂 心
掙 : 亅 ヨ 心 爪
掚 : 一 ｜ 入 冂 心
掞 : 心 火
掤 : 心 月
掦 : ノ 勹 心 日 勿
掭 : 一 丶 亅 大 心 ⺣
掮 : 一 丶 尸 心 戸 月
掯 : 心 月 止
掽 : ｜ 丶 ノ 二 丷 心
揁 : ハ 卜 心 目 貝
揅 : 一 ノ 口 廾 手
揈 : 勹 心 言
揎 : 一 二 宀 心 日 曰
揑 : 工 心 臼
揓 : 一 ｜ ノ 乙 匕 心 也 方
揔 : 丶 ノ 勹 心 心 勿
揕 : 儿 ハ 匚 心 甘
揜 : 一 ㅅ 口 廾 心
揠 : 匚 女 心 日
揥 : ｜ 亠 丷 冂 冖 巾 心 立
揪 : ノ 心 木 火 禾
揬 : 丶 儿 ハ 大 宀 心 犬
揲 : 一 ｜ 心 木 世
揳 : 一 ｜ 二 刀 大 心
揵 : ｜ 二 廴 ヨ 心 聿
揸 : 一 心 日 木 目
揹 : 一 ｜ 匕 心 月
搉 : 冖 心 隹
搊 : 勹 屮 心
搐 : 亠 幺 心 玄 田
搒 : 亠 丷 冖 心 方 立
搔 : 丶 又 心 虫
搘 : ノ 匕 土 心 ⺹ 日
搞 : 亠 冂 口 心 高
搠 : 一 丷 屮 心 月
搢 : ｜ 丶 ノ 二 厶 心 日
搤 : 一 丶 ノ ハ 丷 心 皿
搥 : ｜ ノ ⻌ 口 心
搩 : 夕 心 木 舛
搪 : ｜ 口 广 ヨ 心
搯 : 心 爪 臼
搰 : 冂 冖 心 月 骨
搵 : 人 口 心 皿
搽 : 一 ㅅ 小 心 ⺾ 木
搿 : 一 ㅅ 口 手
摋 : 一 丶 ノ 几 又 小 心 殳
摏 : 一 大 心 臼
摑 : 口 囗 心 戈
摒 : 一 ｜ ノ 丷 尸 廾 心
摓 : 一 ｜ 二 ⻌ 夂 心
摔 : 丶 ノ 亠 冫 十 幺 心 玄
摚 : 冖 口 土 ⺌ 心
摛 : 丶 ノ 亠 冂 凵 厶 心 ⽱
摜 : 一 ハ 心 田 目 貝
摝 : 匕 广 心 比 鹿
摟 : 一 ｜ 口 女 心 日
摠 : ノ 口 夂 心 心
摡 : 厶 心 无 日
摣 : 一 匕 卜 厂 心 目 虍
摭 : 一 ｜ 广 心 ⺣
摳 : 匚 口 心
摴 : 一 ｜ 二 冖 勹 心 雨
摻 : ㅅ 厶 彡 心
摽 : 二 小 心 示 西
撅 : 一 人 丷 勹 厂 屮 心 欠
撇 : ｜ 丶 ノ ハ 丷 冂 心 攵
撏 : 口 寸 工 ヨ 心
撐 : 冖 口 ⺌ 心 牙
撑 : 冖 口 ⺌ 心 手
撘 : 一 ㅅ 口 心 竹
撙 : ハ 丷 寸 心 酉
撛 : 夕 心 米 舛
撝 : 一 亅 尸 心 戸 ⺣ 爪
撟 : ノ 冂 口 大 心
撡 : 丶 亅 ㅅ 厶 心 ⺣
撣 : 十 口 心 日 田
撦 : ノ 土 大 心 ⺹ 日 曰
撨 : 心 ⺣ 隹
撬 : ノ 乙 二 心
撳 : 人 勹 心 欠 金
撽 : 心 攵 方 日 白
撾 : 冂 ⻌ 口 囗 心
撿 : 一 人 ㅅ 口 心
擄 : 一 力 匕 卜 厂 心 田 虍
擉 : 勹 心 ⺲ 虫
擊 : 几 凵 又 手 殳 車
擋 : 冖 口 ⺌ 心 田
擌 : 人 大 心 竹
擎 : 勹 口 ⺾ 手 攵
擐 : 一 口 心 ⺲ 衣
擑 : 口 心 戈 耳
擕 : ｜ 亅 心 隹
擗 : 十 口 尸 心 立 辛
擤 : 廾 心 田 目 自 鼻
擥 : 一 丶 ノ 匚 手 ⺲ 臣
擩 : 冖 心 而 雨
擪 : 丶 厂 大 手 日 月 犬
擭 : 又 心 ⺾ 隹
擰 : 一 亅 宀 心 心 皿
擵 : 广 心 手 木 麻
擷 : ハ 口 士 心 目 貝 頁
擻 : 一 ｜ 口 女 心 攵 日 田
擿 : 亠 丷 冂 十 ⻌ 口 心 立 啇
攁 : 一 丶 二 丷 大 心 艮
攄 : 匕 卜 厂 心 心 田 虍
攈 : ノ 匕 广 心 木 比 禾 鹿
攉 : 一 ｜ 丶 ⺅ 冖 心 隹 雨
攊 : ノ 厂 心 木 止 禾
攏 : 一 ｜ 乙 心 月 立 竜
攓 : 一 ｜ 二 ハ 口 宀 心 足
攔 : 丷 口 心 木 門
攖 : ハ 女 心 目
攙 : 一 ｜ 丶 儿 勹 匕 口 心 比 免
攛 : 儿 ハ 宀 心 臼 鼠
攞 : 丶 小 幺 心 ⺲ 糸 隹
攟 : ノ 匕 口 广 心 木 比 禾 鹿
攢 : ノ 儿 ハ 土 心 目 貝
攦 : 一 丶 冂 匕 广 心 比 鹿
攩 : 丷 冖 口 ⺌ 心 ⺣ 里 黒
攮 : 一 ｜ 二 冖 十 口 心 衣
攱 : 十 又 支 立
攺 : 尸 攵
攼 : 一 十 干 攵
攽 : ハ 刀 攵
敃 : 一 乙 尸 攵 氏
敇 : 冂 攵 木
敉 : 攵 米
敐 : 亠 厂 攵 衣 辰
敒 : ｜ ⺅ 攵 日 田
敔 : 一 二 口 攵 五
敟 : 一 ｜ 攵 皿
敠 : 卜 又
敧 : 亅 卜 又 口 大
敫 : 攵 方 日 白
敺 : 匚 卜 又 口
敽 : ノ 冂 又 口 大
斁 : 一 丷 十 土 干 攵 ⺲
斅 : 一 ｜ 冖 卜 又 子 ヨ 爻
斊 : 文 耳
斒 : 一 ｜ 丶 ノ 亅 冂 尸 戸 冊 廾
斕 : 丶 ノ 丷 口 木 門
斘 : 夕 斗
斝 : 冖 口 斗
斠 : 一 ｜ 二 斗 月 用
斣 : 勹 斗 ⺲ 虫
斦 : 斤
斮 : ｜ 二 斤 日 曰
斲 : 一 ｜ ノ 口 斤 爿
斳 : 二 十 口 廾 斤 革
斴 : 夕 斤 米 舛
斿 : 一 ノ 亅 方
旂 : 一 ノ 斤 方
旈 : ｜ ノ 乙 亠 厶 川 方
旉 : 一 ｜ 丶 十 方 日
旎 : 一 ノ 匕 尸 方
旐 : 一 丶 ノ 儿 冫 方
旔 : ｜ 二 廴 ヨ 方 聿
旖 : 一 ノ 亅 口 大 方
旘 : 亠 丷 戈 方 日 立
旟 : 一 ｜ ノ ハ ヨ 方
旰 : 一 十 干 日
旲 : 大 日
旴 : 一 亅 二 十 干 日
旵 : 山 日 曰
旹 : ｜ 亠 山 日
旾 : ノ 乙 凵 日 曰 屯
旿 : 一 ノ 十 干 日 曰
昀 : 一 丶 二 勹 日
昄 : ノ 厂 又 日
昈 : 一 丶 尸 戸 日
昉 : 方 日
昍 : 日 曰
昑 : 丶 ㅅ 日
昒 : ノ 勹 日 曰 勿
昕 : 斤 日
昖 : ハ 厶 日 曰
昝 : 卜 夂 日 曰
昞 : 一 人 冂 日
昡 : 亠 幺 日 玄
昢 : ｜ 凵 山 日
昣 : ㅅ 彡 日 曰
昤 : 一 ｜ 丶 亅 ㅅ マ 日
昦 : ｜ ノ 大 日 曰
昩 : 一 日 曰 木
昪 : 厶 廾 日
昫 : 勹 口 日
昬 : 一 尸 日 氏
昮 : 力 工 日
昰 : 一 日 止
昱 : 日 立
昳 : 一 ノ 大 日 矢
昹 : 丶 日 曰 水
昷 : 日 曰 皿
晀 : 丶 ノ 儿 冫 日 曰
晅 : 一 日
晆 : 土 日 曰
晊 : 一 厶 土 日 曰 至
晌 : ノ 冂 口 日
晑 : ノ 冂 口 日
晎 : ｜ 二 ハ 日
晗 : 一 丶 ㅅ 口 日
晘 : 一 十 干 日 曰
晙 : 儿 ハ 厶 夂
晛 : 儿 日 目 見
晜 : ｜ ノ 丷 弓 日
晠 : ノ 亅 厂 戈 日
晡 : 一 ｜ 丶 十 日 月 用
曻 : 夕 日 舛
晪 : 一 ｜ ハ 日
晫 : 十 卜 日
晬 : 亠 人 十 日
晾 : 亠 口 小 日
晳 : 斤 日 木
晵 : 丶 尸 戸 攵 日 曰
晿 : 日 曰
晷 : 人 卜 口 夂 日
晸 : 一 攵 日 止
晹 : ノ 勹 日 曰 勿
晻 : 乙 大 日 奄
暀 : 丶 亠 土 彳 日 王
晼 : 卩 夕 宀 日 曰
暋 : 一 尸 攵 日 氏
暌 : 一 大 日 癶
暍 : 人 勹 日
暐 : 口 日 韋
暒 : 日 生
暙 : 一 二 大 日
暚 : 凵 山 日 曰 爪 缶
暛 : 一 ノ 二 丷 工 日 曰
暜 : 日 曰 立
暟 : 丷 口 山 日 曰 豆
暠 : 亠 冂 口 日 高
暤 : 十 大 日 白
暭 : 丶 ノ 二 冫 十 日 白
暱 : 匚 口 ⺾ 日 石
暲 : 十 日 立
暵 : 十 口 大 廾 日 革
暻 : 亠 口 小 日
暿 : 一 丷 十 口 士 日 豆
曀 : 丷 冖 口 士 日 豆
曂 : ｜ 二 ハ 日 曰 田
曃 : ⻌ ヨ 日 曰 水 隶
曈 : 日 立 里
曌 : ハ 宀 工 日 曰 月
曎 : 一 丷 十 土 干 日 曰 ⺲
曏 : 丶 匕 厶 幺 ⻏ 日 白
曔 : 勹 口 ⺾ 攵 日 曰
曛 : 一 ノ 丷 日 ⺣ 車
曟 : 亠 厂 日 衣 辰
曨 : 一 ｜ 乙 日 月 田 立 竜
曫 : 丶 ノ 小 幺 日 曰 糸 言
曬 : 一 丶 冂 匕 广 日 比 鹿
曮 : 厂 ユ 口 攵 日 曰 耳
曺 : 十 日
朅 : 人 勹 厶 土 日
朇 : ｜ ノ ㅅ 丷 十 口 日 曰 白
朎 : 一 ｜ 丶 亅 ㅅ 厶 月
朓 : 丶 ノ 儿 冫 月
朙 : 儿 ハ 冂 口 囗 月
朜 : 亠 口 子 月
朠 : 大 ⺾ 月
朢 : 匚 月 王 臣
朳 : ハ 木
朾 : 一 亅 木
杅 : 亅 二 木
杇 : 二 勹 木
杈 : 丶 又 木
杌 : 一 儿 木
杔 : 一 ノ 乙 木
杕 : 大 木
杝 : ｜ 乙 匕 也 木
杦 : 夂 木
杬 : 二 儿 木 元
杮 : 一 ｜ 冂 巾 木
杴 : 人 勹 木 欠
杶 : ノ 乙 凵 木 屯
杻 : ｜ ヨ 木
极 : 丶 乃 及 木
构 : 勹 厶 木
枎 : 一 大 木
枏 : 二 冂 月 木
枑 : 一 ヨ 彑 木
枓 : 斗 木
枖 : ノ 大 木
枘 : 人 入 冂 木
枙 : 卩 厂 木
枛 : 木 爪
枰 : 一 丶 ノ ハ 丷 十 干 木
枱 : 厶 口 木
枲 : 厶 口 木
枵 : 一 勹 口 木
枻 : 一 ｜ 木 世
枼 : 一 ｜ 木 世
枽 : 一 凵 十 木
柹 : 木 牙
柀 : ｜ ノ 十 厂 又 支 木
柂 : 一 ｜ ノ 乙 匕 也 木
柃 : 一 丶 亅 ㅅ マ 木
柅 : 匕 尸 木
柈 : 一 二 ハ 木
柉 : 丶 ノ 乙 木
柒 : 一 乙 匕 ⺡ 木
柗 : ハ 口 木
柙 : ｜ 日 木 田
柜 : 匚 口 木
柡 : 二 木 水
柦 : 一 日 曰 木
柰 : 二 小 木 示
柲 : ノ 心 木
柶 : 儿 口 木
柷 : 儿 口 木
桒 : 十 ⺾ 木
栔 : 一 ｜ 二 刀 木
栙 : ｜ 二 夂 木
栝 : 口 木 舌
栟 : 一 丷 廾 木
栨 : 一 人 冫 勹 木 欠
栧 : ノ 乙 日 木 田
栬 : 乙 勹 已 木 巴 色
栭 : 木 而
栯 : 一 ノ 月 木
栰 : ⺅ 戈 木
栱 : ｜ 二 ハ 木
栳 : ノ 匕 土 ⺹ 木
栻 : 工 弋 木
栿 : 丶 ⺅ 大 木 犬
桄 : 一 儿 ⺌ 木
桅 : 勹 卩 厂 木
桊 : 一 丶 ノ 丷 大 木
桌 : 卜 日 木
桕 : 木 臼
桗 : 乃 木
桘 : ｜ ノ 口 木
桛 : 一 卜 木
桫 : ノ 小 ⺡ 木
桮 : 一 ｜ 丶 ノ 口 木
桯 : 口 木 王
桰 : 口 木 氏
桱 : 一 巛 工 木
桲 : 冖 十 子 木
桵 : 女 木 爪
桹 : 丶 木 艮
桺 : 一 ｜ 廾 木
桻 : 一 ｜ 二 夂 木
桼 : ㅅ 木 水
梂 : 一 丶 木 水
梄 : 木 酉
梆 : 一 ノ ⻏ 木
梈 : 一 亅 亠 口 木
梖 : ハ 木 目 貝
梘 : 儿 木 目 見
梚 : 一 ｜ 儿 勹 口 木 免
梜 : 人 大 木
梡 : 二 儿 宀 木 元
梣 : 一 丶 ㅅ 山 木
梥 : ハ 厶 宀 木
梩 : 木 里
梪 : 丷 口 木 豆
梮 : 亅 口 尸 木
梲 : 儿 ハ 口 木
梻 : ⺅ 廾 弓 木
棅 : ノ ヨ 木 禾 耒
棈 : 二 亠 土 月 木 青
棌 : 木 爪
棏 : 一 寸 日 木
棐 : 木 非
棑 : 木 非
棓 : 口 木 立
棖 : 木 長
棙 : 一 丶 大 尸 戸 木 犬
棜 : 丶 ㅅ 方 木
棝 : 十 口 囗 木
棥 : 木 爻
棨 : 一 尸 戸 攵 木
棪 : 木 火
棫 : 一 口 戈 木
棬 : 一 ハ 丷 卩 大 木
棭 : 丶 亠 ⺅ 夂 木
棰 : 一 ｜ ノ 二 日 木
棱 : 儿 ハ 土 夂 木
棵 : 木 田
棶 : 人 木
棻 : ハ 刀 ⺾ 木
棼 : ハ 刀 木
棽 : 丶 ㅅ 木
椆 : 冂 口 土 木
椉 : 亠 夕 木 舛
椊 : 亠 人 十 木
椐 : 十 口 尸 木
椑 : ノ 十 日 木 白
椓 : 丶 木 豕
椖 : 一 丶 尸 戸 方 木
椗 : 宀 木 疋
椱 : 一 ノ 夂 日 曰 木
椳 : 木 田 衣
椵 : 一 ｜ 又 木
椸 : 一 ｜ ノ 乙 匕 也 方 木
椻 : 匚 女 日 木
楂 : 一 日 木 目
楅 : 一 口 木 田
楉 : 一 ノ 口 ⺾ 木
楎 : 冖 木 車
楗 : ｜ 二 廴 ヨ 木 聿
楛 : 十 口 ⺾ 木
楣 : ｜ 尸 木 目
楤 : 丶 ノ 勹 心 木 勿
楥 : ノ 二 又 木 爪
楦 : 一 宀 日 曰 木
楨 : ハ 卜 木 目 貝
楩 : 一 丶 ノ ⺅ 日 木
楬 : 人 勹 日 木
楰 : 人 大 木 臼
楱 : 一 二 大 木
楲 : 一 ノ 厂 女 戈 木
楺 : マ 木 矛
楻 : 日 木 王 白
楿 : ノ 日 木 禾 香
榀 : 口 木
榍 : ⺌ 尸 月 木
榒 : 丶 冫 弓 木
榖 : 一 冖 几 又 士 木 殳
榘 : 一 ノ 匚 大 木 矢 臣
榡 : 一 ｜ 二 小 幺 木 糸
榥 : 一 儿 ⺌ 日 木
榦 : ㅅ 十 口 日 木
榨 : 一 ｜ ノ 儿 ハ 宀 木
榫 : 十 木 隹
榭 : ノ 寸 木 目
榯 : 土 寸 日 木
榷 : 冖 木 隹
榸 : 土 木 里
榺 : 一 ハ 丷 大 月 木
榼 : 厶 土 木 皿
槅 : 儿 冂 口 木 鬲
槈 : 厂 寸 木 衣 辰
槑 : 口 木
槖 : 冖 口 士 木 石
槗 : 一 ノ 冂 口 木
槢 : ノ 冫 日 木 白 羽
槥 : 一 ｜ ヨ 木
槮 : ㅅ 厶 彡 木
槯 : 山 木 隹
槱 : 木 ⺣ 酉
槳 : 丶 夕 寸 木 爿
槵 : ｜ 口 心 木
槾 : 又 日 木 ⺲
樀 : 亠 丷 冂 十 口 木 立 啇
樁 : 一 丶 ノ 二 大 木 臼
樃 : 丶 厶 日 月 木
樏 : 小 幺 木 田 糸
樑 : 丶 ノ 刀 ⺡ 木
樕 : 人 勹 口 木 欠
樚 : 匕 广 木 比 鹿
樝 : 一 匕 卜 厂 木 目 虍
樠 : 一 ｜ 入 冂 凵 木
樤 : 一 ｜ ⺅ 夂 小 木
樨 : ｜ 丶 ノ 冫 尸 木 牛
樰 : 二 冖 ヨ 木 雨
樲 : 二 弋 木
樴 : 亠 丷 戈 日 木 立
樷 : 又 木 耳
樻 : 一 ｜ ハ 口 木 目 虫 貝
樾 : 一 ｜ 十 土 戈 木 止 疋
樿 : 十 口 日 木 田
橅 : 一 ｜ ノ 木 ⺣ 無
橆 : 一 ノ 木 皿
橉 : 夕 木 米 舛
橊 : 一 ｜ 木 田
橎 : ノ 木 田 米
橐 : 一 冖 口 木 石
橑 : 丶 ノ 大 小 日 木
橒 : 一 ｜ 二 冖 厶 木 雨
橕 : 冖 口 ⺌ 木 牙
橖 : 冖 口 ⺌ 木
橛 : 一 人 丷 勹 厂 屮 木 欠
橤 : 心 木
橧 : ｜ 丷 口 日 木
橪 : 丶 夕 大 木 ⺣ 犬
橱 : 丷 厂 口 寸 木 豆
橳 : 一 ハ 丷 力 大 月 木
橾 : 口 木
檁 : ノ 亠 口 囗 木 禾
檃 : 工 ヨ ⻖ 木 爪
檆 : 卜 口 木 火
檇 : ｜ 亅 木 隹
檉 : 口 木 王 耳
檋 : ｜ 丶 ノ 二 木 車
檑 : 一 ｜ 二 冖 木 田 雨
檛 : 冂 ⻌ 口 木
檝 : 口 戈 木 耳
檞 : ｜ 刀 勹 月 木 牛 角
檟 : ハ 木 目 西 貝
檥 : 丷 戈 手 木 王
檫 : 丶 二 夕 宀 小 木 示
檯 : 一 冖 厶 口 土 士 木 至
檰 : ｜ 冂 小 巾 幺 日 木 白 糸
檱 : ｜ 二 ハ 木 目 竹 貝
檴 : 又 ⺾ 木 隹
檽 : 一 ｜ 二 冖 木 而 雨
檾 : 冖 木 火
檿 : 丶 厂 大 日 月 木 犬
櫆 : 儿 匕 厶 斗 木 田 鬼
櫉 : 丷 十 厂 口 士 寸 木 豆
櫈 : 丷 几 口 木 癶 豆
櫌 : 一 冖 夂 心 木 目 自
櫐 : 木 田
櫔 : ｜ 冂 厂 厶 ⺾ 日 木 田 ⽱
櫕 : 一 ハ 木 目 貝
櫖 : 匕 卜 厂 心 木 田 虍
櫜 : 一 ｜ 冖 卜 口 夂 木
櫝 : 儿 ハ 口 士 木 目 ⺲ 貝
櫤 : 一 丶 丷 冂 ⺉ 月 木 竹
櫧 : ノ 土 ⺹ 日 木 言
櫬 : 一 儿 小 木 目 立 見
櫰 : ｜ 丶 ノ 亠 冫 木 ⺲ 衣
櫱 : ｜ ノ 十 口 屮 木 立 辛
櫲 : ノ 亅 勹 マ 口 木 矛 豕
櫼 : 一 人 戈 木 非
櫽 : 工 ヨ ⻖ 心 木 爪
欂 : 丶 十 寸 ⺡ ⺾ 日 木 田
欃 : 一 ｜ 丶 儿 勹 匕 口 木 比 免
欆 : 又 木 隹
欇 : 木 耳
欉 : 一 ｜ 丶 ノ 丷 又 木 王 耳
欏 : 小 幺 木 ⺲ 糸 隹
欐 : 一 丶 冂 匕 广 木 比 鹿
欑 : ノ 儿 ハ 土 木 目 貝
欗 : 丷 口 ⺾ 木 門
欛 : 一 ｜ 二 冖 十 口 廾 月 木 雨 革
欞 : 一 ｜ 二 人 冖 口 工 雨
欤 : 一 亅 人 勹 卜 欠
欨 : 人 勹 口 欠
欫 : ノ 二 人 勹 欠 止
欬 : ノ 亠 人 勹 幺 欠 玄
欯 : 人 勹 口 士 欠
欵 : 一 ノ 人 勹 匕 大 欠 矢
欶 : 人 勹 口 木 欠
欻 : 人 勹 欠 火
欿 : 人 勹 欠 臼
歆 : 人 勹 日 欠 立 音
歊 : 亠 人 冂 勹 口 欠 高
歍 : 人 勹 欠 ⺣ 鳥
歒 : 亠 人 丷 冂 勹 十 口 欠 立 啇
歖 : 一 人 丷 勹 十 口 士 欠 豆
歘 : 人 勹 欠 火
歝 : 一 人 丷 勹 十 土 干 欠 ⺲
歠 : 人 勹 又 欠 酉
歧 : 十 又 支 止
歫 : 匚 口 止
歮 : 止
歰 : ノ 刀 止
歵 : 一 ｜ 二 ハ 止 目 貝
歽 : 斤 歹
歾 : ノ 勹 歹 勿
殂 : 一 歹 目
殅 : 歹 生
殗 : 乙 大 日 歹 奄
殛 : 一 亅 又 口 歹
殟 : 日 曰 歹 皿
殠 : 丶 大 歹 犬 目 自
殢 : 一 ｜ ノ 乙 冂 冖 巾 廾 歹
殣 : 二 十 口 廾 歹 革
殨 : 一 ｜ ハ 口 歹 目 虫 貝
殩 : 卜 又 夕 歹 米
殬 : 一 丷 十 土 干 歹 ⺲
殭 : 一 歹 田
殮 : 一 人 ㅅ 口 歹
殰 : 儿 ハ 口 士 歹 目 ⺲ 貝
殸 : ｜ 几 又 士 尸 殳
殹 : 一 ノ 几 匚 又 大 殳 矢
殽 : 一 丶 ノ 几 又 月 殳
殾 : 丶 ノ 几 又 土 ⺹ 日 殳
毃 : 亠 冂 几 又 口 殳 高
毄 : 几 又 口 殳 車
毉 : 一 ノ 人 几 匚 又 大 工 殳 矢
毌 : 一 日 田
毖 : ノ 匕 心 比
毚 : 一 ｜ 儿 勹 匕 口 比 免
毡 : ノ 乙 二 卜 口
毣 : ノ 乙 二 冫 羽
毦 : ノ 乙 二 耳
毧 : 一 ノ 乙 二 戈
毮 : ノ 乙 二 小 心
毱 : ノ 乙 二 勹 米
毷 : ノ 乙 二 冂 目
毹 : 一 ノ 乙 二 ㅅ ⺉ 月
毿 : ノ 乙 二 ㅅ 厶 彡
氂 : 一 ノ 乙 二 厂 攵 木
氄 : ノ 乙 二 儿 ハ 冂 マ 口 矛
氅 : ノ 乙 二 冂 口 ⺌ 攵
氉 : ノ 乙 二 口 木
氍 : ノ 乙 二 目 隹
氎 : ノ 乙 二 夕 宀 田
氐 : 一 丶 氏
氒 : ノ 十 氏
氙 : 山 气
氟 : 廾 弓 气
氦 : ノ 亠 幺 气 玄
氧 : 丷 气 王 羊
氨 : 女 宀 气
氬 : ｜ 二 气
氮 : 气 火
氳 : 人 口 气 皿
氵 : ⺡
氶 : 一 水
氺 : 水
氻 : 力 ⺡
氿 : 九 ⺡
汊 : 丶 又 ⺡
汋 : 丶 勹 ⺡
汍 : 丶 九 ⺡
汏 : 大 ⺡
汒 : 亠 ⺡ 亡
汔 : 一 ノ 乙 ⺡
汙 : 亅 二 ⺡
汛 : 一 ノ 乙 十 ⺡
汜 : 已 ⺡
汫 : 一 ｜ ノ 二 廾 ⺡
汭 : 人 入 冂 ⺡
汯 : 一 ノ 厶 ⺡
汴 : 一 丶 亠 卜 ⺡
汶 : ⺡ 文
汸 : ⺡ 方
汹 : 丶 ノ 凵 ⺡
汻 : 一 ノ 十 干 ⺡
沅 : 二 儿 ⺡ 元
沆 : 亠 几 ⺡
沇 : 儿 厶 ⺡
沉 : 冖 几 ⺡
沔 : 一 ｜ 亅 ⺡
沕 : ノ 勹 ⺡ 勿
沗 : 一 大 水
沘 : 匕 ⺡ 比
沜 : ⺡ 片
沟 : 勹 厶 ⺡
沰 : 口 ⺡ 石
沲 : 一 ｜ ノ 乙 匕 ⺡ 也
沴 : ㅅ 彡 ⺡
泂 : 冂 口 ⺡
泆 : 一 ノ 大 ⺡
泍 : 一 ⺡ 木
泏 : ｜ 凵 山 ⺡
泐 : 力 ⺡ ⻖
泑 : 力 幺 ⺡
泒 : 厶 ⺡ 瓜
泔 : ⺡ 甘
泖 : ノ 卩 ⺡
泚 : 匕 ⺡ 止
泜 : 一 丶 ⺡ 氏
泠 : ｜ 丶 亅 ㅅ マ ⺡
泧 : ｜ ⺡ 戈
泩 : ⺡ 生
泫 : 亠 幺 ⺡ 玄
泬 : ハ 宀 ⺡
泮 : ｜ 二 ハ 丷 ⺡
泲 : ノ 亅 ⺡
泴 : 水 皿
洄 : 口 囗 ⺡
洇 : 口 大 ⺡
洊 : 一 ｜ ノ 子 ⺡
洎 : ⺡ 目 自
洏 : ⺡ 而
洑 : 丶 ⺅ 大 ⺡ 犬
洓 : 冂 ⺡ 木
洚 : ｜ 夂 ⺡
洦 : 一 ⺡ 日 白
洧 : 一 ノ ⺡ 月
洨 : 亠 ⺡ 父
汧 : 一 ｜ ノ 廾 ⺡
洮 : 丶 ノ 儿 冫 ⺡
洯 : 一 ｜ 二 刀 彡 水
洱 : ⺡ 耳
洹 : 一 ⺡ 日
洼 : 土 ⺡
洿 : 二 勹 大 ⺡
浗 : 一 丶 ⺡ 水
浞 : 口 ⺡ 足
浟 : ｜ ⺅ ⺡ 攵
浡 : 冖 十 子 ⺡
浥 : 乙 口 已 ⺡ ⻏ 巴
浧 : 口 ⺡ 王
浯 : 一 二 口 ⺡ 五
浰 : ノ ⺉ ⺡ 木 禾
浼 : 一 ｜ 儿 勹 口 ⺡ 免
涂 : 二 ㅅ 小 ⺡ 示
涇 : 一 巛 工 ⺡
涑 : 口 ⺡ 木
涒 : ノ 口 ヨ ⺡
涔 : 一 丶 ㅅ 山 ⺡
涖 : ⺅ ⺡ 立
涗 : 儿 ハ 口 ⺡
涘 : 一 ノ 厶 大 ⺡ 矢
涪 : 口 ⺡ 立
涬 : 一 丷 十 土 干 ⺡
涴 : 卩 夕 宀 ⺡
涷 : ⺡ 日 木
涹 : ノ 女 ⺡ 木 禾
涽 : ⺡ 日 曰 氏
涿 : 丶 ⺡ 豕
淄 : 巛 ⺡ 田
淈 : ｜ 凵 尸 山 ⺡
淊 : 勹 ⺡ 臼
淎 : 一 ｜ 二 大 ⺡
淏 : 一 大 ⺡ 日
淖 : 十 卜 ⺡ 日
淛 : ｜ 冂 ⺉ 巾 ⺡ 牛
淝 : 乙 已 ⺡ 月 巴
淟 : 一 ｜ ハ ⺡ 日
淠 : 一 ｜ ノ 廾 ⺡ 田
淢 : 一 口 ⺡ 戈
淥 : ヨ 彑 ⺡ 水
淩 : 儿 ハ 土 夂 ⺡
淯 : 亠 厶 ⺡ 月
淰 : 一 丶 ㅅ ⺡ 心
淴 : ノ 勹 ⺡ 心 勿
淶 : 人 ⺡ 木
淼 : 水
渀 : 十 大 廾 ⺡
渄 : ⺡ 非
渞 : 丷 ⺡ 目 自 首
渢 : ノ 冂 ⺡ 虫 風
渧 : ｜ 亠 丷 冂 冖 巾 ⺡ 立
渲 : 一 宀 ⺡ 日
渶 : 口 大 ⺡ ⺾
渹 : 勹 ⺡ 言
渻 : ノ 小 ⺡ 目
渼 : 丷 大 ⺡ 王
湄 : ｜ 尸 ⺡ 目
湅 : 丷 口 ⺡ 木
湈 : ⺡ 木 甘
湉 : 口 ⺖ ⺡ 舌
湋 : 口 ⺡ 韋
湏 : ハ ⺡ 目 貝 頁
湑 : ⺡ 月 疋
湒 : 口 ⺡ 耳
湓 : ハ 刀 ⺡ 皿
湔 : 一 丷 ⺉ ⺡ 月
湗 : 土 寸 ⺡
湜 : ⺡ 日 疋
湝 : 匕 ⺡ 日 比 白
湞 : ハ 卜 ⺡ 目 貝
湢 : 一 口 ⺡ 田
湣 : 尸 ⺡ 日 氏
湨 : ⺡ 木 目
湳 : 一 丷 冂 十 干 ⺡
湻 : 亠 口 ⺡ 日
湽 : 一 巛 ⺡ 田
溍 : ｜ 二 ⺡ 日 曰
溓 : 一 ｜ 丶 ノ 丷 ヨ ⺡
溙 : 一 二 大 ⺡ 水
溠 : 一 ノ 二 丷 工 ⺡
溧 : ⺡ 木 西
溭 : ハ 夂 ⺡ 田
溮 : 一 ｜ ノ 冂 口 巾 ⺡
溱 : 一 ノ 二 大 ⺡ 木 禾
溳 : ハ 口 ⺡ 目 貝
溻 : 丶 冫 ⺡ 日 曰 羽
溿 : ｜ 二 ハ 丷 ⺡ 田
滀 : 亠 幺 ⺡ 玄 田
滁 : 一 ㅅ 小 ⺡ ⻖
滃 : 丶 ノ ハ 冫 厶 ⺡ 羽
滇 : 一 ハ 匕 十 ⺡ 目
滈 : 亠 冂 口 ⺡ 高
滊 : ⺡ 气 米
滍 : 一 ｜ 凵 ⺡ 虫
滎 : 冖 水 火
滏 : 丷 ⺡ 父 王
滫 : ｜ ⺅ 夂 ⺡ 攵 月
滭 : ｜ 二 十 口 ⺡ ⺾ 里
滮 : 几 匕 卜 厂 彡 ⺡ 虍
滹 : 一 丶 ノ 亅 丷 匕 卜 厂 ⺡ 虍
滻 : 丶 ノ 亠 丷 厂 ⺡ 生
滽 : ｜ 二 冂 广 ヨ ⺡ 聿
漄 : 厂 土 山 ⺡
漈 : 丶 二 夕 小 ⺡ 示
漊 : 一 ｜ 口 女 ⺡ 日
漌 : 二 十 口 廾 ⺡ 革
漍 : 一 口 囗 ⺡ 戈
漖 : ノ 土 子 ⺡ ⺹ 攵
漘 : 亠 厂 ⺡ 月 衣 辰
漚 : 匚 口 ⺡
漛 : 一 丶 ノ 丷 大 ⺡ 水
漦 : 一 厂 攵 木 水
漩 : 一 ノ ⺡ 方 疋
漪 : 亅 口 大 ⺡ ⺨
漯 : 小 幺 ⺡ 田 糸
漰 : 丶 冂 山 ⺡ 月
漳 : 十 ⺡ 日 立 音
漶 : ｜ 口 ⺡ 心
漻 : ㅅ 冫 彡 ⺡ 羽
漼 : 山 ⺡ 隹
漭 : 丶 大 廾 ⺡ ⺾ 犬
潏 : ハ 冂 マ 口 ⺡ 矛
潑 : 丶 ノ 几 又 弓 ⺡ 殳
潒 : ｜ ノ 勹 口 ⺡ 豕
潓 : 一 十 厶 ⺡ 心 日 田 虫
潗 : ⺡ 木 隹
潙 : ノ 亅 ⺡ ⺣ 爪
潚 : ｜ ヨ ⺡ 爿 片
潝 : 一 ㅅ 冫 口 ⺡ 羽
潞 : 口 夂 ⺡ 止 足
潡 : 亠 口 子 ⺡ 攵
潢 : ハ ⺡ 田 黄
潨 : ｜ 丶 ノ ⺡ 皿 ⺲
潬 : 十 口 ⺡ 日 田
潽 : ｜ 二 丷 ⺡ 日
潾 : 夕 ⺡ 米 舛
澃 : ハ 彡 水 目 貝 頁
澇 : 冖 力 ⺡ 火
澈 : 亠 厶 ⺡ 攵 月
澋 : 亠 口 小 ⺡ 日
澌 : ｜ 二 ハ ⺡ 斤 甘
澍 : 一 丷 十 口 士 寸 ⺡ 豆
澐 : 一 ｜ 二 冖 厶 ⺡ 雨
澒 : ハ 工 ⺡ 目 貝 頁
澓 : 一 ノ 夂 彳 ⺡ 日 曰
澔 : ｜ ノ 二 口 土 ⺡ 日 牛 白
澖 : ⺡ 木 門
澚 : 一 ノ 冂 勹 ⺡ 米
澟 : ノ 亠 口 囗 ⺡ 木 禾
澠 : ⺡ 黽
澥 : ｜ 刀 勹 ⺡ 月 牛 角
澦 : 一 亅 ハ マ ⺡ 目 矛 貝 頁
澧 : ｜ 丷 口 ⺡ 日 豆
澨 : 人 工 ⺡ 竹
澮 : 一 ｜ ㅅ 丷 口 ⺡ 日
澯 : 卜 又 夕 ⺡ 米
澰 : 一 人 ㅅ 口 ⺡
澵 : 一 小 ⺡ 斤 木 立
澶 : 一 亠 口 囗 ⺡ 日
澼 : 十 口 尸 ⺡ 立 辛
濅 : ｜ 冂 冖 又 宀 巾 ヨ ⺡
濇 : 人 口 囗 土 ⺡
濈 : 口 ⺡ 戈 耳
濊 : ノ 厂 小 ⺡ 戈 止
濚 : 冖 ⺡ 木 火
濞 : 廾 ⺡ 田 目 自 鼻
濨 : 一 丷 幺 ⺡ 心
濩 : 又 ⺡ ⺾ 隹
濰 : 小 幺 ⺡ 糸 隹
濵 : ｜ ハ 宀 尸 ⺡ 目 貝
濹 : ｜ 二 丷 口 土 ⺡ ⺣ 里 黒
濼 : 幺 ⺡ 日 木 白
濽 : 一 ハ 大 ⺡ 目 貝
瀀 : 一 冖 夂 ⺡ 心 目 自
瀅 : 丶 冖 ⺡ 火 王
瀆 : 儿 ハ 口 士 ⺡ 目 ⺲ 貝
瀇 : ハ 广 ⺡ 田 黄
瀍 : 儿 ハ 土 广 ⺡ 里
瀗 : 一 ｜ 二 宀 ⺡ 心 ⺲
瀠 : 冖 小 幺 ⺡ 水 糸
瀣 : 一 卜 又 夕 ⺡ 非
瀯 : 冖 口 ⺡ 火
瀴 : ハ 女 ⺡ 目 貝
瀷 : ｜ 二 ハ 冫 ⺡ 田 羽
瀹 : 一 ｜ 亅 ㅅ 冂 口 ⺡ 冊 龠 廾
瀼 : 一 ｜ 二 亠 口 ⺡ 衣
灃 : 一 ｜ 丷 口 山 ⺡ 豆
灄 : ⺡ 耳
灈 : ⺡ 目 隹
灉 : 乙 口 巛 已 ⺡ ⻏ 巴 隹
灊 : 一 ｜ 儿 丷 冂 口 ⺡ 无 鬲
灋 : 一 ｜ 亅 厶 土 广 ⺡ ⺣
灔 : ｜ 乙 丷 勹 口 已 ⺡ 日 巴 色 豆
灕 : 丶 ノ 亠 冂 凵 厶 ⺡ ⽱ 隹
灝 : 亠 ハ 口 小 ⺡ 日 目 貝 頁
灞 : 一 ｜ 二 冖 十 口 廾 ⺡ 月 雨 革
灎 : ｜ 丷 厶 口 土 ⺡ 日 皿 豆
灤 : 小 幺 ⺡ 木 糸 言
灥 : 日 水 白
灬 : ⺣
灮 : 儿 火
灵 : ヨ 火
灶 : 土 火
灾 : 宀 火
炁 : 无 ⺣
炅 : 日 火
炆 : 文 火
炔 : 人 ユ 火
炕 : 亠 几 火
炖 : ノ 乙 凵 火 屯
炗 : 一 凵 火
炘 : 斤 火
炛 : ノ 乙 ⺅ 匕 火
炤 : 刀 口 火
炫 : 亠 幺 火 玄
炰 : 勹 已 ⺣
炱 : 厶 口 火
炴 : 口 大 火
炷 : 丶 亠 土 火 王
烊 : 丷 火 王 羊
烑 : 丶 ノ 儿 冫 火
烓 : 土 火
烔 : 一 冂 口 火
烕 : 一 ノ 厂 戈 火
烖 : 土 戈 火
烘 : ｜ 二 ハ 火
烜 : 一 日 火
烤 : 一 ノ 勹 土 ⺹ 火
烺 : 丶 火 艮
焃 : 土 火 赤
焄 : ノ 口 ヨ ⺣
焅 : ノ 口 土 火
焆 : 口 月 火
焇 : 小 ⺌ 月 火
焋 : 士 火 爿
焌 : 儿 ハ 厶 夂 火
焏 : 一 亅 又 口 ⺣
焞 : 亠 口 子 火
焠 : 亠 人 十 火
焫 : 人 入 冂 ⺾ 火
焭 : 冖 几 火
焯 : 十 卜 日 火
焰 : 勹 火 臼
焱 : 火
焸 : 日 曰 火
煁 : 一 ｜ ハ 匚 火 甘
煅 : 一 ｜ ノ 几 又 殳 火
煆 : 一 ｜ 又 火
煇 : 冖 火 車
煊 : 一 宀 日 火
煋 : 日 曰 火 生
煐 : 口 大 ⺾ 火
煒 : 口 火 韋
煗 : 大 火 而
煚 : 一 匚 日 曰 火
煜 : 日 火 立
煞 : 勹 ヨ 攵 ⺣
煠 : 一 ｜ 木 火 世
煨 : 火 田 衣
煹 : 一 ｜ 二 月 火
熀 : 一 儿 ⺌ 日 火
熅 : 人 口 火 皿
熇 : 亠 冂 口 火 高
熌 : 人 火 門
熒 : 冖 火
熚 : 一 ｜ 凵 口 火 里
熛 : 二 小 火 示 西
熠 : 冫 日 火 白 羽
熢 : 一 ｜ 二 ⻌ 夂 火
熯 : 一 丶 ノ 十 口 大 廾 火 革
熰 : 匚 口 火
熲 : ハ 匕 火 目 貝 頁
熳 : 又 日 火 ⺲
熺 : 一 丷 十 口 士 火 豆
熿 : ハ 火 田 黄
燀 : 十 口 日 火 田
燁 : 一 ｜ ⺾ 火
燄 : 勹 火 臼
燋 : 火 ⺣ 隹
燌 : ハ 十 ⺾ 火 目 貝
燓 : 木 火 爻
燖 : 口 寸 工 ヨ 火
燙 : 一 ノ 勹 ⺡ 日 火 勿
燚 : 火
燜 : 心 火 門
燸 : 一 ｜ 二 冖 火 而 雨
燾 : 一 口 士 寸 工 ⺣
爀 : 土 火 赤
爇 : 丶 儿 ハ 九 土 ⺾ ⺣
爈 : 匕 卜 厂 心 火 田 虍
爉 : 丶 ノ 乙 口 川 巛 火
爓 : 勹 火 臼 門
爗 : 一 ｜ 二 ⺾ 日 火
爚 : 一 ｜ 亅 ㅅ 冂 口 火 冊 龠 廾
爝 : 一 厶 寸 日 火 爪 ⺲
爟 : 一 ｜ 卜 口 ⺾ 火 隹
爤 : 丷 口 ⺾ 木 火 門
爫 : 爪
爯 : 一 ｜ 冂 十 月 爪
爴 : 一 口 囗 戈 爪
爸 : 乙 已 父 巴
爹 : 夕 父
牁 : 一 亅 口 爿
牂 : 丷 爿 王 羊
牃 : 一 ｜ 木 爿 世
牅 : ｜ 二 冂 广 ヨ 爿 聿
牎 : 丶 ノ 勹 心 片 勿
牏 : 一 丶 ノ ㅅ 冂 ⺉ 月 片
牐 : ノ 十 片 臼
牓 : 亠 丷 冖 方 片 立
牕 : ノ 口 囗 夂 心 片
牖 : 一 丶 十 尸 戸 月 片
牚 : 冖 口 ⺌ 牙
牜 : 牛
牞 : 力 牛
牠 : ｜ 乙 匕 也 牛
牣 : ノ 刀 牛
牨 : 亠 几 牛
牫 : 戈 牛
牮 : ⺅ 戈 牛
牯 : 十 口 牛
牱 : 一 亅 口 牛
牷 : ㅅ 牛 王
牸 : 子 宀 牛
牻 : 丶 尢 彡 牛 尤
牼 : 一 巛 工 牛
牿 : ノ 口 土 牛
犄 : 一 亅 口 大 牛
犉 : 亠 口 子 牛
犍 : ｜ 二 廴 ヨ 牛 聿
犎 : 土 寸 牛
犓 : 勹 屮 牛
犛 : 一 厂 攵 木 牛
犨 : 牛 隹
犭 : ⺨
犮 : 丶 ノ 又 大 弋 犬
犱 : 丶 九 ⺨
犴 : 一 十 干 ⺨
犾 : 丶 大 ⺨ 犬
狁 : 儿 厶 ⺨
狇 : ⺨ 木
狉 : 一 ｜ 丶 ノ ⺨
狌 : ⺨ 生
狕 : 力 幺 ⺨
狖 : ハ 宀 ⺨
狘 : ⺨ 戈
狟 : 一 ⺨ 日 曰
狥 : 勹 ⺨ 日
狳 : 一 丶 ノ 亅 二 ㅅ 小 ⺨
狴 : 匕 土 ⺨ 比
狺 : ⺨ 言
狻 : 儿 ハ 厶 夂 ⺨
狾 : 心 ⺨ 斤
猂 : 一 十 干 ⺨ 日
猄 : 亠 口 小 ⺨
猅 : ⺨ 非
猇 : 儿 几 匕 卜 厂 ⺨ 虍
猋 : 丶 大 犬
猍 : 人 ⺨ 木
猒 : 丶 大 日 月 犬
猓 : 一 ｜ 口 ⺨ 木 田
猘 : 一 ｜ ノ 冂 ⺉ 巾 ⺨ 牛
猙 : 亅 ヨ ⺨ 爪
猞 : 一 ㅅ 十 口 干 ⺨
猢 : 十 口 ⺨ 月
猤 : 一 丶 ノ 大 ⺨
猧 : 冂 口 ⺨
猨 : ノ 二 又 ⺨ 爪
猬 : ⺨ 月 田
猱 : マ ⺨ 木 矛
猲 : 人 勹 ⺨ 日 曰
猵 : 一 ｜ 丶 亅 冂 尸 ⺨ 冊 廾
猺 : 丶 凵 夕 山 ⺨ 爪 缶
猻 : 子 小 幺 ⺨ 糸
猽 : 亠 ハ 冖 ⺨ 日
獃 : 丶 丷 口 大 山 犬 豆
獍 : 儿 ⺨ 日 立 音
獐 : 十 ⺨ 日 立 音
獒 : 丶 土 士 大 攵 方 犬
獖 : ハ 十 ⺨ ⺾ 目 貝
獘 : ｜ 丶 ハ 丷 冂 大 攵 犬
獝 : ハ 冂 マ 口 ⺨ 矛
獞 : ⺨ 立 里
獟 : 一 儿 土 ⺨
獠 : 丶 ノ 大 小 ⺨ 日 曰
獦 : 人 勹 ⺨ ⺾ 日
獧 : 一 口 ⺨ ⺲ 衣
獩 : 一 ノ 厂 小 ⺨ 戈 止
獫 : 一 人 ㅅ 口 ⺨
獬 : ｜ 刀 勹 ⺨ 月 牛 角
獮 : 一 ｜ ハ 冂 ⺨ 爻
獯 : 一 ｜ ノ 二 丷 ⺨ ⺣
獱 : 一 ｜ ノ ハ 宀 ⺨ 目 貝
獷 : ハ 广 ⺨ 田 黄
獹 : 匕 卜 厂 ⺨ 田 皿 虍
獼 : 一 ｜ ハ 冂 弓 ⺨ 爻
玀 : 小 幺 ⺨ ⺲ 糸 隹
玁 : 一 ｜ 厂 口 ⺨ 攵 耳
玃 : 又 ⺨ 目 隹
玅 : ノ 亠 小 幺 玄
玆 : 亠 幺 玄
玎 : 一 亅 王
玐 : ハ 王
玓 : 丶 勹 王
玕 : 一 十 干 王
玗 : 亅 二 王
玘 : 已 王
玜 : ハ 厶 王
玞 : 一 大 王
玟 : 文 王
玠 : ｜ ノ ㅅ 王
玢 : ハ 刀 王
玥 : 月 王
玦 : 人 ユ 王
玪 : 丶 ㅅ 王
玫 : 攵 王
玭 : 匕 比 王
玵 : 王 甘
玷 : 卜 口 王
玹 : 亠 幺 王 玄
玼 : 匕 止 王
玽 : 勹 口 王
玿 : 刀 口 王
珅 : ｜ 日 王
珆 : 厶 口 王
珉 : 尸 氏 王
珋 : ｜ ノ 卩 王
珌 : ノ 心 王
珏 : 丶 王
珒 : ｜ 二 ヨ 王 聿
珓 : 亠 父 王
珖 : 一 儿 ⺌ 王
珙 : ｜ 二 ハ 王
珝 : 冫 王 羽
珡 : ㅅ 王
珣 : 勹 日 王
珦 : ノ 冂 口 王
珧 : 丶 ノ 儿 冫 王
珩 : 彳 王 行
珴 : 戈 手 王
珵 : ノ 口 土 王
珷 : 一 弋 止 王
珹 : ノ 亅 厂 戈 王
珺 : ノ 口 ヨ 王
珻 : 一 ノ 王 毋 母
珽 : ノ 土 士 廴 王
珿 : 口 王 足
琀 : 丶 ㅅ 口 王
琁 : 一 ノ 王 疋
琄 : 口 月 王
琇 : ノ 乃 木 王 禾
琊 : ⻏ 王 牙
琑 : ⺌ 月 王
琚 : 十 口 尸 王
琛 : 儿 ハ 冖 木 王
琤 : 亅 勹 ヨ 爪 王
琦 : 一 亅 口 大 王
琨 : 匕 日 比 王
琩 : 日 王
琪 : ｜ 二 ハ 王 甘
琫 : 一 ｜ 二 大
琬 : 卩 夕 宀 王
琭 : ヨ 水 王
琮 : 二 宀 小 王 示
琯 : ｜ 口 宀 王
琰 : 火 王
琱 : 冂 口 土 王
琹 : 木 王
瑀 : ノ 冂 厶 王 ⽱ 虫
瑃 : 一 二 大 日 王
瑄 : 一 宀 日 王
瑆 : 日 王 生
瑇 : 一 ｜ 二 王 毋 母
瑋 : 口 王 韋
瑍 : 儿 ハ 冂 勹 大 王
瑑 : ヨ 彑 王 豕
瑒 : 一 ノ 勹 日 王 勿
瑗 : ノ 二 又 爪 王
瑝 : 日 王 白
瑢 : ㅅ ハ 口 宀 王 谷
瑦 : ⺣ 王 鳥
瑧 : 一 ノ 二 大 木 王 禾
瑨 : ｜ 丶 ノ 二 日 曰 王
瑫 : 爪 王 臼
瑭 : ｜ 口 广 ヨ 王
瑮 : 木 王 西
瑱 : 一 ハ 匕 十 王 目
瑲 : 一 丶 ㅅ 口 尸 王
璀 : 山 王 隹
璁 : ノ 口 夂 心 王
璅 : 巛 木 王 田
璆 : ㅅ 冫 彡 王 羽
璇 : 一 ノ 方 王 疋
璉 : ⻌ 王 車
璏 : 一 ノ 匕 大 ヨ 彑 王 矢
璐 : 口 夂 止 王 足
璑 : 一 ｜ ノ ⺣ 王 無
璒 : 丶 ノ ハ 丷 口 王 豆
璘 : 夕 王 米 舛
璙 : 丶 ノ 大 小 日 王
璚 : ハ 冂 マ 口 王 矛
璜 : ハ 王 田 黄
璟 : 亠 口 小 日 王
璠 : ノ 王 田 米
璡 : ⻌ 王 隹
璣 : 人 幺 戈 王
璦 : 冖 夂 心 爪 王
璨 : 卜 又 夕 王 米
璩 : 匕 卜 厂 王 虍 豕
璪 : 口 木 王
璫 : 冖 口 ⺌ 王 田
璮 : 一 亠 口 囗 日 曰 王
璯 : 一 ｜ ㅅ 丷 口 日 王
璱 : ノ 心 王
璲 : 丷 ⻌ 王 豕
璵 : 一 ｜ ハ 王
璹 : 一 口 士 寸 工 王
璻 : ノ 亠 人 冫 十 王 羽
璿 : 一 ㅅ ハ 冖 卜 王 目
瓈 : ノ ㅅ 勹 木 水 王 禾
瓉 : 一 ハ 大 王 目 貝
瓌 : 一 ｜ 丶 ノ 亠 冫 王 ⺲ 衣
瓐 : 匕 卜 厂 王 田 皿 虍
瓓 : 丷 口 木 王 門
瓘 : 口 ⺾ 王 隹
瓚 : ノ 儿 ハ 土 王 目 貝
瓛 : 丶 儿 冂 匕 卜 厂 口 大 犬 王 虍 鬲
瓞 : 一 丶 ノ 二 厶 大 瓜
瓟 : 勹 厶 已 瓜
瓤 : 一 ｜ 二 亠 厶 口 瓜 衣
瓨 : 一 丶 乙 工
瓪 : 一 丶 ノ 乙 又
瓫 : 一 丶 乙 ハ 刀
瓯 : 一 丶 ノ 乙 匚
瓴 : 一 ｜ 丶 乙 亅 ㅅ マ
瓺 : 一 ｜ 丶 乙 厶
瓻 : 一 ｜ 丶 ノ 乙 冂 巾
瓼 : 一 丶 乙 里
瓿 : 一 丶 乙 口 立
甆 : 一 丶 乙 丷 幺
甒 : 一 ｜ 丶 ノ 乙 ⺣ 無
甖 : 一 丶 乙 ハ 目 貝
甗 : 一 丶 乙 儿 冂 匕 卜 厂 口 虍 鬲
甠 : 日 生
甡 : 生
甤 : 生 豕
甧 : 月 生
甩 : 乙 二 冂 月
甪 : ノ 用
甯 : 宀 心 用
甶 : ノ 田
甹 : 一 ｜ 勹 日 田
甽 : 川 田
甾 : 巛 田
甿 : 亠 亡 田
畀 : 廾 田
畃 : ｜ 丶 勹 日
畇 : 一 丶 勹 田
畈 : ノ 厂 又 田
畎 : 丶 大 犬 田
畐 : 一 口 田
畒 : 亠 人 田
畗 : 亠 口 田
畞 : 十 夂 田
畟 : ハ 夂 田
畡 : ノ 亠 幺 玄 田
畯 : 儿 ハ 厶 夂 田
畱 : 一 ｜ 田
畹 : 卩 夕 宀 田
畺 : 一 田
畻 : 一 丷 土 大 田
畼 : 一 ノ 勹 日 曰 勿 田
畽 : 一 ノ 田 車
畾 : 田
疁 : ㅅ 冫 彡 田 羽
疅 : 一 田
疐 : 冖 十 田 疋
疒 : ⽧
疓 : 乃 ⽧
疕 : 匕 ⽧
疙 : 一 ノ 乙 ⽧
疜 : 一 卜 ⽧
疢 : 火 ⽧
疤 : 乙 已 巴 ⽧
疴 : 一 亅 口 ⽧
疺 : 丶 ノ 乙 ⽧
疿 : 廾 弓 ⽧
痀 : 勹 口 ⽧
痁 : 卜 口 ⽧
痄 : 一 ｜ ノ ⽧
痆 : 匕 尸 ⽧
痌 : 一 冂 口 ⽧
痎 : ノ 亠 幺 玄 ⽧
痏 : 一 ノ 月 ⽧
痗 : 一 ノ 毋 ⽧ 母
痜 : ノ 几 木 ⽧ 禾
痟 : 小 ⺌ 月 ⽧
痠 : 儿 ハ 厶 夂 ⽧
痡 : 一 ｜ 丶 月 ⽧
痤 : 人 土 ⽧
痧 : ノ 小 ⺡ ⽧
痬 : ノ 勹 日 勿 ⽧
痮 : ⽧ 長
痯 : ｜ 口 宀 ⽧
痱 : ⽧ 非
痹 : 廾 田 ⽧
瘀 : 丶 ㅅ 方 ⽧
瘂 : 一 ｜ ⽧
瘃 : 丶 ⽧ 豕
瘄 : ｜ 二 日 ⽧
瘇 : 一 ノ ⽧ 車
瘈 : 一 ｜ 刀 大 ⽧
瘊 : 一 ノ ⺅ ユ 大 ⽧ 矢
瘌 : ⺉ 口 木 ⽧
瘏 : ノ 土 ⺹ 日 ⽧
瘒 : 冖 ⽧ 車
瘓 : 儿 ハ 冂 勹 大 ⽧
瘕 : 一 ｜ 又 口 ⽧
瘖 : 日 ⽧ 立 音
瘙 : 丶 又 ⽧ 虫
瘛 : 一 ｜ 刀 彡 心 ⽧
瘜 : 心 ⽧ 目 自
瘝 : ｜ 丶 ノ ⽧ ⺲
瘞 : 人 土 大 ⽧
瘣 : 儿 匕 厶 田 ⽧ 鬼
瘥 : 一 ノ 二 丷 工 王 ⽧
瘦 : 十 又 支 ⽧ 臼
瘩 : 一 ㅅ 口 ⺾ ⽧
瘭 : 二 小 ⽧ 示 西
瘲 : 人 彳 止 ⽧
瘳 : ノ ㅅ 冫 彡 ⽧ 羽
瘵 : 丶 二 夕 小 ⽧ 示
瘸 : 入 冂 力 口 ⽧ 肉
瘹 : 丶 勹 ⽧ 金
瘺 : 尸 ⽧ 雨
瘼 : 大 ⺾ 日 ⽧
癊 : 一 丶 ㅅ 厶 ユ ⻖ ⽧
癀 : ハ 田 ⽧ 黄
癁 : 一 ノ 夂 彳 日 ⽧
癃 : 一 夂 ⻖ 生 ⽧
癄 : ⺣ ⽧ 隹
癅 : 一 ｜ 田 ⽧
癉 : 十 口 日 田 ⽧
癋 : 一 ｜ 二 心 ⽧
癕 : 亠 幺 ⽧ 隹
癙 : ⽧ 臼 鼠
癟 : 一 ｜ 亅 ㅅ 冂 ⽧ 目 冊 自 廾
癤 : 匕 卩 厶 日 ⽧ 白 竹
癥 : 一 山 彳 攵 王 ⽧
癭 : ハ 女 ⽧ 目 貝
癮 : 工 ヨ ⻖ 心 爪 ⽧
癯 : ⽧ 目 隹
癱 : 丶 ノ 二 十 口 大 廾 ⽧ 隹 革
癴 : 小 幺 手 ⽧ 糸 言
皁 : 十 日 白
皅 : 乙 已 日 巴 白
皌 : 一 日 木 白
皍 : 匕 卩 日 白
皕 : 一 日 白
皛 : 日 白
皜 : 亠 冂 口 日 白 高
皝 : 一 儿 ⺌ 日 王 白
皟 : 一 ｜ 二 ハ 日 白 目 貝
皠 : 山 日 白 隹
皢 : 一 儿 土 日 白
皣 : 一 ｜ 二 ⺾ 日 白
皤 : ノ 日 田 白 米
皥 : ｜ 丶 ノ 二 冫 日 白 目 自
皦 : 攵 方 日 白
皧 : 冖 夂 心 日 爪 白
皨 : 土 日 白
皪 : 幺 日 木 白
皭 : 一 厶 寸 日 爪 白 ⺲
皽 : 一 ノ 亠 十 又 口 囗 支 日
盁 : 乃 皿
盅 : ｜ 口 皿
盉 : ノ 木 皿 禾
盋 : 又 弋 皿
盌 : 卩 夕 皿
盎 : 口 大 皿
盔 : 一 ノ 火 皿
盙 : 丶 十 月 皿
盠 : ヨ 彑 皿 豕
盦 : 一 丶 ㅅ 皿 酉
盨 : ハ 彡 皿 目 貝 頁
盬 : 一 ノ 匚 十 口 干 皿 臣
盰 : 一 十 干 目
盱 : 亅 二 目
盶 : 二 儿 元 目
盹 : ノ 乙 凵 屯 目
盼 : ハ 刀 目
眀 : 月 目
眆 : 方 目
眊 : 一 ノ 乙 目
眎 : 二 小 目 示
眒 : ｜ 日 目
眔 : ｜ 丶 ノ ⺲
眕 : ㅅ 彡 目
眗 : 勹 口 目
眙 : 厶 口 目
眚 : 生 目
眜 : 一 木 目
眢 : 卩 夕 目
眨 : 丶 ノ 乙 目
眭 : 土 目
眮 : 一 冂 口 目
眯 : 目 米
眴 : 勹 日 目
眵 : 夕 目
眶 : 匚 王 目
眹 : 一 ハ 丷 大 目
眽 : 丶 ノ 目
眾 : ｜ ノ 人 ⺅ ⺲
睂 : ｜ ㅅ 厂 目
睅 : 一 十 干 日 目
睆 : 二 儿 宀 元 目
睊 : 口 月 目
睍 : 儿 目 見
睎 : 一 ｜ 丶 ノ 冂 巾 目
睏 : 囗 木 目
睒 : 火 目
睖 : ハ 土 夂 目
睗 : ノ 勹 日 曰 勿 目
睜 : 亅 ヨ 爪 目
睞 : 人 木 目
睟 : 亠 人 十 目
睠 : 一 丶 ノ ハ 丷 卩 大 目
睢 : 目 隹
睤 : 廾 田 目
睧 : 日 氏 目
睪 : 一 丷 十 土 干 ⺲
睬 : 木 爪 目
睰 : 一 ノ 口 ⺾ 目
睲 : 日 生 目
睳 : 土 大 目
睴 : 冖 目 車
睺 : 一 ノ ⺅ ユ 大 目 矢
睽 : 一 丶 ノ 大 目
瞀 : マ 攵 目 矛
瞄 : ⺾ 田 目
瞌 : 厶 土 皿 目
瞍 : 十 又 支 目 臼
瞔 : 一 ｜ 二 ハ 目 貝
瞕 : 十 日 目 立 音
瞖 : 一 ノ 几 匚 又 大 殳 目 矢
瞚 : 一 ｜ ハ 宀 日 田 目
瞟 : 二 小 目 示 西
瞢 : 冖 ⺾ 目 ⺲
瞧 : ⺣ 目 隹
瞪 : 丶 ノ 丷 口 目 豆
瞮 : 亠 厶 攵 月 目
瞯 : 月 目 門
瞱 : ｜ 二 ⺾ 目
瞵 : 夕 目 米 舛
瞾 : 儿 ハ 宀 工 目
矃 : 一 亅 宀 心 皿 目
矉 : 一 ｜ ノ ハ 宀 目 貝
矑 : 匕 卜 厂 田 皿 目 虍
矒 : 冖 ⺾ 目 ⺲
矕 : 小 幺 目 糸 言
矙 : ユ 攵 目 耳 門
矞 : 儿 ハ 冂 マ 口 矛
矟 : マ ⺌ 月 矛
矠 : ｜ 二 マ 日 矛
矤 : 一 ノ 大 弓 矢
矦 : 一 ノ 勹 厂 大 矢
矪 : 一 ｜ 丶 ノ 冂 大 矢 舟
矬 : 一 ノ 人 土 大 矢
矰 : 一 ｜ ノ ハ 丷 口 大 日 矢
矱 : 一 ノ 又 大 ⺾ 矢 隹
矴 : 一 亅 口 石
矸 : 一 十 口 干 石
矻 : 一 ノ 乙 口 石
砅 : 口 水 石
砆 : 一 口 大 石
砉 : 一 ｜ 二 口 彡 石
砍 : 人 勹 口 欠 石
砎 : ｜ ノ ㅅ 口 石
砑 : 口 石 牙
砝 : 厶 口 土 石
砡 : 丶 口 王 石
砢 : 一 亅 口 石
砣 : 匕 口 宀 石
砭 : ｜ 丶 ノ 乙 口 石
砮 : 又 口 女 石
砰 : 一 ハ 丷 十 口 干 石
砵 : 一 口 木 石
砷 : ｜ 口 日 田 石
硃 : 一 ノ 口 木 石
硄 : 一 儿 口 ⺌ 石
硇 : 丶 ノ 口 囗 石
硈 : 口 士 石
硌 : 口 夂 石
硎 : 一 ⺉ 口 廾 石
硒 : 口 石 西
硜 : 一 口 巛 工 石
硞 : 口 土 石
硠 : 丶 口 石 艮
硡 : 一 ノ 厶 口 宀 石
硣 : ノ 口 土 子 ⺹ 石
硤 : 人 口 大 石
硨 : 口 石 車
硪 : 口 戈 手 石
确 : ｜ 勹 口 月 石 角
硺 : 丶 口 石 豕
硾 : 一 ｜ ノ 二 口 石
碊 : 口 戈 石
碏 : ｜ 二 口 日 曰 石
碔 : 一 口 弋 止 石
碘 : 一 ｜ ハ 口 日 石
碡 : 一 ｜ 二 口 毋 石 母
碝 : 口 大 石 而
碞 : 口 石
碟 : 一 ｜ 口 木 石 世
碤 : 口 大 ⺾ 石
碨 : 口 田 石 衣
碬 : 一 ｜ 又 口 石
碭 : 一 ノ 勹 口 日 勿 石
碰 : ｜ 丶 ノ 二 丷 口 石
碱 : 一 ノ 厂 口 戈 石
碲 : ｜ 亠 丷 冂 冖 口 巾 石 立
碳 : 一 ノ 口 山 火 石
碻 : 亠 冂 口 石 高
碽 : ハ 口 工 目 石 貝
碿 : 口 ⺌ 尸 月 石
磇 : 丶 ノ 匕 口 囗 比 石
磈 : 儿 匕 厶 口 田 石 鬼
磉 : 又 口 木 石
磌 : 一 ハ 匕 十 口 目 石 貝
磎 : 口 大 幺 爪 石
磒 : ハ 口 目 石 貝
磓 : ｜ ノ ⻌ 口 石
磕 : 厶 口 土 皿 石
磖 : 冫 口 日 白 石 羽
磤 : ノ 亅 几 又 口 ヨ 殳 石
磛 : 口 斤 石 車
磟 : ㅅ 冫 口 彡 石 羽
磠 : 丶 ノ 十 卜 口 囗 石 鹵
磡 : 一 ｜ 儿 ハ 力 匚 口 甘 石
磦 : 二 口 小 石 示 西
磪 : 口 山 石 隹
磲 : 匚 口 ⺡ 木 石
磳 : ｜ 丷 口 日 曰 石
礀 : 口 月 石 門
磶 : 勹 口 ⺣ 石 臼
磷 : 口 夕 石 米 舛
磺 : ハ 口 田 石 黄
磻 : ノ 口 田 石 米
磿 : ノ 厂 口 木 石 禾
礆 : 一 人 ㅅ 口 石
礌 : 二 冖 口 田 石 雨
礐 : 一 ｜ ノ 冖 口 爻 石
礚 : 厶 口 土 ⺾ 皿 石
礜 : 一 ｜ ノ 口 大 石
礞 : 一 冖 口 ⺾ 石 豕
礟 : 口 爻 石 馬
礠 : 一 丷 口 幺 心 石
礥 : ハ 匚 又 口 目 石 臣 貝
礧 : 口 田 石
礩 : ハ 口 斤 目 石 貝
礭 : 二 冖 口 石 隹 雨
礱 : 一 乙 口 月 石 立 竜
礴 : 丶 十 口 寸 ⺡ ⺾ 月 石
礵 : 二 冖 口 木 目 石 雨
礻 : ⺭
礽 : 乃 ⺭
礿 : 一 丶 勹 ⺭
祄 : ｜ ノ ㅅ ⺭
祅 : ｜ ノ 二 大 ⺭
祆 : 一 ｜ ノ 二 大 ⺭
祊 : ｜ ノ 二 方 ⺭
祋 : 几 又 殳 ⺭
祏 : 口 ⺭ 石
祑 : 一 ノ 大 ⺭
祔 : ｜ ノ 二 ⺅ 寸 ⺭
祘 : 二 小 示
祛 : ｜ ノ 二 厶 土 ⺭
祜 : ｜ ノ 二 十 口 ⺭
祧 : ｜ 丶 ノ 二 儿 冫 ⺭
祩 : 一 ノ 木 ⺭
祫 : 一 ｜ ノ 二 ㅅ 口 ⺭
祲 : ｜ ノ 二 冖 又 ヨ ⺭
祹 : ｜ ノ 二 凵 勹 山 ⺭ 缶
祻 : 十 口 囗 ⺭
祼 : ｜ ノ 二 日 木 ⺭ 田
祾 : ハ 土 夂 ⺭
禋 : ｜ ノ 二 土 ⺭ 西
禌 : 一 丷 幺 ⺭
禑 : 冂 厶 ⺭ 田 ⽱
禓 : 一 ノ 勹 日 ⺭ 勿
禔 : ｜ ノ 二 日 ⺭ 疋
禕 : ｜ ノ 二 口 ⺭ 韋
禖 : ｜ ノ 二 木 ⺭ 甘
禘 : ｜ ノ 二 亠 丷 冂 冖 巾 ⺭ 立
禛 : 一 ｜ ノ 二 ハ 匕 十 ⺭ 目 貝
禜 : 二 冖 小 火 示
禡 : ｜ ノ 二 ⺭ 馬
禨 : 人 幺 戈 ⺭
禩 : ｜ ノ 二 ハ ⺭ 田
禫 : 一 ｜ ノ 二 冂 十 日 ⺭ 西
禯 : ｜ 厂 日 ⺭ 衣 辰
禱 : 一 ｜ ノ 二 口 士 寸 工 ⺭
禴 : 一 ｜ ノ 亅 二 ㅅ 冂 口 ⺭ 冊 龠 廾
禸 : 冂 厶 ⽱
离 : 丶 ノ 亠 冂 凵 十 厶 ⽱
秂 : ノ 人 木 禾
秄 : ノ 子 木 禾
秇 : 丶 ノ 九 木 禾
秈 : ノ 山 木 禾
秊 : ノ 十 木 禾
秏 : ノ 乙 二 木 禾
秔 : ノ 亠 几 木 禾
秖 : ノ 木 氏 禾
秚 : ｜ 丶 ノ 二 ハ 丷 木 禾
秝 : ノ 木 禾
秞 : ｜ ノ 日 木 田 禾
秠 : 一 ｜ 丶 ノ 二 木 禾
秢 : 丶 ノ ㅅ マ 木 禾
秥 : ノ 卜 口 木 禾
秪 : 一 丶 ノ 木 氏 禾
秫 : 一 ｜ 丶 ノ 乙 木 禾
秭 : ｜ ノ 亅 木 禾
秱 : 一 ノ 冂 口 木 禾
秸 : ノ 口 士 木 禾
秼 : 一 ノ 木 禾
稂 : 丶 ノ 木 禾 艮
稃 : ノ 子 木 爪 禾
稇 : ノ 囗 木 禾
稉 : 一 丶 ノ 日 木 禾
稊 : ｜ ノ 丷 弓 木 禾
稌 : 一 ノ ㅅ 小 木 禾
稑 : ノ 儿 ハ 土 木 禾
稕 : ノ 亠 口 子 木 禾
稛 : ノ 囗 木 禾
稞 : ノ 日 木 田 禾
稡 : ノ 亠 人 十 木 禾
稧 : 一 ｜ ノ 刀 大 木 禾
稫 : 一 ノ 口 木 田 禾
稭 : ノ 匕 日 木 比 白 禾
稯 : 丶 ノ ハ 凵 十 夂 木 禾
稰 : ノ 月 木 疋 禾
稴 : 一 ｜ 丶 ノ ヨ 木 禾
稵 : 一 ノ 丷 幺 木 禾
稸 : ノ 亠 幺 木 田 禾
稹 : 一 ノ ハ 匕 十 木 目 禾 貝
稺 : ノ 十 尸 木 禾 立 辛
穄 : 丶 ノ 二 夕 小 木 示 禾
穅 : ノ 广 ヨ 木 水 禾 隶
穇 : ノ ㅅ 厶 彡 木 禾
穈 : ノ 广 木 禾 麻
穌 : ノ 木 ⺣ 田 禾 魚
穕 : ノ 木 禾 隹
穖 : ノ 人 幺 戈 木 禾
穙 : 一 ｜ 丶 ノ 二 丷 大 木 禾
穜 : ノ 木 禾 立 里
穝 : ノ 又 日 木 禾 耳
穟 : ノ ハ 丷 ⻌ 木 禾 豕
穠 : ｜ ノ 亠 厂 日 木 禾 衣 辰
穥 : 一 ｜ ノ 亠 ハ 木 禾
穧 : ノ 亠 刀 木 氏 禾 齊
穪 : 一 ｜ ノ ハ 冂 木 爻 禾
穭 : ノ 日 木 ⺣ 田 禾 魚
穵 : 乙 儿 ハ 宀
穸 : 儿 ハ 夕 宀
穾 : ノ ハ 大 宀
窀 : ノ 乙 儿 ハ 凵 宀 屯
窂 : 儿 ハ 宀 牛
窅 : 儿 ハ 宀 目
窆 : 丶 ノ 乙 儿 ハ 宀
窊 : 儿 ハ 厶 宀 瓜
窋 : ｜ ハ 凵 宀
窐 : 儿 ハ 土 宀
窑 : ハ 凵 宀 山 缶
窔 : 亠 儿 ハ 宀 父
窞 : ハ 勹 宀 臼
窠 : 儿 ハ 宀 日 木 田
窣 : 亠 人 儿 ハ 十 宀
窬 : 一 丶 ㅅ 儿 ハ 冂 ⺉ 宀 月
窳 : 儿 ハ 厶 宀 瓜
窵 : 儿 ハ 宀 ⺣ 鳥
窹 : 一 二 儿 ハ 口 宀 爿 五
窻 : ノ 儿 ハ 口 夂 宀 心
窼 : 儿 ハ 宀 巛 日 木 田
竆 : 一 ノ 儿 ハ 口 宀 牙
竉 : 乙 ハ 宀 月 立 竜
竌 : 几 立
竎 : 廾 立
竑 : 一 ノ 厶 立
竛 : 丶 ㅅ マ 立
竨 : 十 卜 日 立
竩 : 一 宀 目 立
竫 : 亅 勹 ヨ 爪 立
竬 : ノ 冂 厶 口 ⽱ 立 虫
竱 : 一 厶 寸 日 立 虫
竴 : ハ 丷 寸 立 酉
竻 : 力 竹
竽 : 亅 二 竹
竾 : ｜ 乙 匕 也 竹
笇 : 亠 卜 竹
笔 : 一 ノ 乙 竹
笟 : 厶 瓜 竹
笣 : 勹 已 竹
笧 : 一 ｜ 亅 冂 冊 竹 廾
笩 : ⺅ 弋 竹
笪 : 一 日 竹
笫 : 亅 牙 竹
笭 : 一 ｜ 丶 亅 ㅅ マ 竹
笮 : 一 ｜ ノ 竹
笯 : 又 女 竹
笰 : 廾 弓 竹
笱 : 勹 口 竹
笴 : 一 亅 口 竹
笽 : 皿 竹
笿 : 口 夂 竹
筀 : 土 竹
筁 : ｜ 日 竹
筇 : 工 ⻏ 竹
筎 : 口 女 竹
筕 : 彳 竹 行
筠 : 一 丶 勹 土 竹
筤 : 丶 竹 艮
筦 : 二 儿 宀 元 竹
筩 : マ 用 竹
筪 : ｜ 匚 日 田 竹
筭 : 一 ｜ 二 廾 竹
筯 : 力 目 竹
筲 : 小 ⺌ 月 竹
筳 : ノ 土 士 廴 王 竹
筷 : 人 ユ ⺖ 竹
箄 : ノ 十 日 白 竹
箉 : 力 口 心 竹
箎 : 几 匕 卜 厂 竹 虍
箐 : 一 ｜ 二 亠 冂 土 月 竹 青
箑 : 土 ヨ 竹 走
箖 : 木 竹
箛 : 厶 子 瓜 竹
箞 : 一 丶 ノ 乙 亅 ハ 丷 大 竹
箠 : 一 ｜ ノ 二 竹
箥 : ノ 十 厂 又 ⺡ 支 竹
箬 : 一 ノ 口 ⺾ 竹
箯 : 一 丶 ノ ⺅ 日 竹
箰 : 勹 子 日 竹
箲 : ノ 儿 土 ⺡ 竹
箵 : ノ 小 目 竹
箶 : 十 口 月 竹
箺 : 一 丶 ノ 二 大 日 曰 竹
箻 : ｜ 二 ヨ 彳 竹 聿
箼 : 一 厶 土 尸 竹
箽 : 一 ノ 竹 車
篂 : 日 曰 生 竹
篅 : 山 竹 而
篈 : 土 寸 竹
篊 : ｜ 二 ハ ⺡ 竹
篔 : ハ 口 目 竹 貝
篖 : ｜ 口 广 ヨ 竹
篗 : 又 竹 隹
篙 : 亠 冂 口 竹 高
篚 : 匚 竹 非
篛 : 冫 弓 竹
篨 : 二 ㅅ 小 ⻖ 竹
篪 : 儿 几 匕 卜 厂 竹 虍
篲 : 一 ｜ 二 ヨ 竹
篴 : ⻌ 竹 豕
篵 : 人 彳 止 竹
篸 : ㅅ 厶 彡 竹
篹 : 乙 亅 大 目 竹
篺 : ノ 十 心 日 竹
篼 : 一 ノ 儿 日 白 竹
篾 : 丶 ノ 厂 戈 ⺲ 竹
簁 : 彳 止 竹
簂 : 一 口 囗 戈 竹
簃 : ノ 夕 木 禾 竹
簄 : 丶 乙 口 尸 已 ⻏ 巴
簆 : 二 儿 卜 又 宀 元 竹
簉 : ｜ ノ 二 ⻌ 口 土 竹
簋 : 皿 竹 艮
簌 : 人 勹 口 木 欠 竹
簎 : ｜ 二 心 日 竹
簏 : 匕 广 比 竹 鹿
簙 : 丶 十 寸 月 竹
簛 : 二 ハ 斤 甘 竹
簠 : 丶 十 日 月 皿 竹
簥 : ノ 冂 口 大 竹
簦 : 丶 ノ 丷 口 竹 豆
簨 : ｜ 二 ハ 已 竹
簬 : 口 夂 竹 足
簱 : ｜ 二 ハ 方 甘 竹
簳 : 一 ㅅ 十 干 日 竹
簴 : 一 ｜ 丶 ノ ハ 匕 卜 厂 竹 虍
簶 : ｜ ノ 二 ヨ 水 ⺭ 竹
簹 : 冖 口 ⺌ 田 竹
簺 : 一 ｜ 丶 ノ 二 冖 土 竹
籆 : 又 ⺾ 竹 隹
籊 : 冫 竹 羽 隹
籕 : ノ 刀 厶 木 田 竹
籑 : 一 丶 大 目 竹 艮
籒 : 一 ｜ 心 田 竹
籓 : ノ ⺡ 田 竹 米
籙 : ヨ 彑 水 竹 金
籚 : 匕 卜 厂 田 皿 竹 虍
籛 : 戈 竹 金
籜 : 一 丷 十 土 干 心 ⺲ 竹
籝 : 一 丶 亠 几 口 女 亡 月
籞 : ノ 二 儿 卩 彳 止 元 竹
籡 : 一 人 ㅅ 口 心 竹
籣 : 丷 口 木 竹 門
籧 : 匕 卜 厂 ⻌ 竹 虍 豕
籩 : 儿 ハ ⻌ 宀 方 目 竹 自
籭 : 一 丶 冂 匕 广 比 竹 鹿
籮 : 小 幺 ⺲ 竹 糸 隹
籰 : 又 目 竹 隹
籲 : 一 ｜ 亅 ㅅ ハ 冂 口 目 冊 竹 貝 頁 龠 廾
籹 : 女 米
籼 : 山 米
籽 : 子 米
粆 : ノ 小 米
粇 : 亠 几 米
粏 : 丶 大 米
粔 : 匚 口 米
粞 : 米 西
粠 : ｜ 二 ハ 米
粦 : 夕 米 舛
粰 : 子 爪 米
粶 : ヨ 彑 水 米
粷 : 勹 米
粺 : ノ 十 日 白 米
粻 : 米 長
粼 : 夕 米 舛
粿 : 日 木 田 米
糄 : 一 ｜ 亅 冂 尸 戸 冊 米 廾
糇 : 一 ノ ⺅ ユ 大 矢 米
糈 : 月 疋 米
糉 : 丶 ノ 儿 ハ 凵 夂 米
糍 : 一 丷 幺 米
糏 : ⺌ 尸 月 米
糓 : 一 冖 几 又 士 殳 米
糔 : 丶 又 米 虫
糕 : 丷 ⺣ 王 米
糗 : 丶 大 犬 目 米 自
糙 : ｜ ノ 二 ⻌ 口 土 米
糚 : 士 ⺾ 爿 米
糝 : ㅅ 厶 彡 米
糦 : 一 丷 十 口 士 米 豆
糩 : 一 ｜ ㅅ 丷 口 日 米
糫 : 一 口 ⺲ 米 衣
糵 : ｜ ノ 十 口 ⺾ 立 米 辛
紃 : 小 川 幺 糸
紇 : 一 ノ 乙 小 幺 糸
紈 : 丶 九 小 幺 糸
紉 : ノ 刀 小 幺 糸
紏 : 小 幺 斗 糸
紑 : 一 ｜ 丶 ノ 小 幺 糸
紒 : ｜ ノ ㅅ 小 幺 糸
紓 : マ 小 幺 矛 糸
紖 : ｜ 小 幺 弓 糸
紝 : ノ 士 小 幺 王 糸
紞 : ノ 乙 冖 小 尢 幺 糸
紣 : 十 九 小 幺 糸
紦 : 乙 小 已 幺 巴 糸
紪 : 匕 小 幺 止 糸
紭 : 厶 小 幺 弓 糸
紱 : 丶 ノ 又 大 小 幺 弋 犬 糸
紼 : 小 幺 廾 弓 糸
紽 : 匕 宀 小 幺 糸
紾 : ㅅ 小 幺 彡 糸
絀 : ｜ 凵 小 幺 糸
絁 : 一 ｜ ノ 乙 匕 小 幺 也 糸
絇 : 勹 口 小 幺 糸
絈 : 小 幺 日 白 糸
絍 : ノ ⺅ 士 小 幺 王 糸
絑 : 一 ノ 小 幺 木 糸
絓 : 土 小 幺 糸
絗 : 口 囗 小 幺 糸
絙 : 一 小 幺 日 糸
絚 : 一 丶 二 小 幺 五 糸
絜 : 一 ｜ 二 刀 小 幺 糸
絝 : 二 勹 大 小 幺 糸
絥 : 丶 ⺅ 大 小 幺 犬 糸
絧 : 一 冂 口 小 幺 糸
絪 : 囗 大 小 幺 糸
絰 : 一 厶 土 小 幺 糸 至
絸 : 儿 小 幺 目 糸 見
絺 : 一 ｜ 丶 ノ 冂 小 巾 幺 糸
絻 : 一 ｜ ノ 乙 儿 勹 口 小 幺 糸 免
絿 : 一 丶 小 幺 水 糸
綁 : 一 ノ 小 幺 ⻏ 糸
綂 : 亠 儿 口 小 幺 糸
綃 : 小 ⺌ 幺 月 糸
綅 : 冖 又 小 幺 ヨ 糸
綆 : 一 丶 ノ 小 幺 日 糸
綈 : ｜ ノ 丷 小 幺 弓 糸
綋 : 一 ノ 厶 宀 小 幺 糸
綌 : ㅅ ハ 口 小 幺 糸 谷
綍 : 冖 十 子 小 幺 糸
綑 : 囗 小 幺 木 糸
綖 : ノ 小 幺 廴 止 糸
綗 : 儿 ハ 冂 口 小 幺 糸
綝 : 小 幺 木 糸
綞 : 一 ｜ ノ 小 幺 糸
綦 : ｜ 丶 ノ 二 小 幺 糸
綧 : 亠 口 子 小 幺 糸
綪 : 二 亠 土 小 幺 月 糸 青
綳 : 小 幺 月 糸
綶 : 小 幺 日 木 田 糸
綷 : 亠 人 十 小 幺 糸
綹 : 卜 口 夂 小 幺 糸
緂 : 小 幺 火 糸
緃 : 人 小 幺 止 糸
緄 : 匕 小 幺 日 曰 比 糸
緅 : 又 小 幺 糸 耳
緆 : ノ 勹 小 幺 日 曰 勿 糸
緌 : ノ 女 小 幺 木 禾 糸
緍 : 小 幺 日 曰 氏 糸
緎 : 一 口 小 幺 戈 糸
緗 : 小 幺 木 目 糸
緙 : 十 口 小 幺 廾 糸 革
縀 : 一 ｜ 又 口 小 幺 糸
緢 : 小 幺 ⺾ 田 糸
緥 : ⺅ 口 小 幺 木 糸
緦 : 小 幺 心 田 糸
緪 : 一 丶 二 小 幺 ⺖ 五 糸
緫 : 丶 ノ 勹 小 幺 心 勿 糸
緭 : 小 幺 月 田 糸
緱 : 一 ノ ⺅ ユ 大 小 幺 矢 糸
緵 : 丶 ノ 儿 ハ 凵 夂 小 幺 糸
緶 : 一 丶 ノ ⺅ 小 幺 日 糸
緹 : 小 幺 日 疋 糸
緺 : 冂 口 小 幺 糸
縈 : 冖 小 幺 火 糸
縐 : 勹 小 屮 幺 糸
縑 : 一 ｜ ノ 丷 小 幺 ヨ 糸
縕 : 人 口 小 幺 皿 糸
縗 : 一 亠 口 小 幺 糸 衣
縜 : ハ 口 小 幺 目 糸 貝
縝 : 一 ハ 匕 十 小 幺 目 糸 貝
縠 : 一 冖 几 又 士 小 幺 殳 糸
縧 : 一 ｜ ⺅ 夂 小 幺 木 糸
縨 : 一 儿 小 ⺌ 幺 日 糸
縬 : 一 ノ 卜 厂 小 幺 戈 糸
縭 : 丶 ノ 亠 冂 凵 厶 小 幺 ⽱ 糸
縯 : 一 ｜ ハ 宀 小 幺 日 田 糸
縳 : 一 寸 小 幺 糸 虫
縶 : 一 丶 丷 十 九 土 小 干 幺 糸
縿 : ㅅ 厶 小 幺 彡 糸
繄 : 一 ノ 几 匚 又 大 小 幺 殳 矢 糸
繅 : 小 巛 幺 日 木 田 糸
繇 : 丶 ノ 凵 夕 小 山 幺 爪 糸 缶
繎 : 丶 夕 大 小 幺 ⺣ 犬 糸
繐 : 一 小 幺 心 糸 虫
繒 : ｜ ハ 丷 口 小 幺 日 糸
繘 : ハ 冂 マ 口 小 幺 矛 糸
繟 : 十 口 小 幺 日 田 糸
繡 : ｜ 小 幺 ヨ 爿 片 糸
繢 : 一 ｜ ハ 口 小 幺 目 糸 虫 貝
繥 : 一 丷 十 口 士 小 幺 糸 豆
繫 : 几 凵 又 小 幺 殳 糸 車
繮 : 一 小 幺 田 糸
繯 : 一 口 小 幺 ⺲ 糸 衣
繳 : 小 幺 攵 方 日 白 糸
繸 : ハ 丷 ⻌ 小 幺 糸 豕
繾 : 一 ｜ ⻌ 口 小 幺 糸 虫
纁 : 一 ｜ ノ 二 丷 口 小 幺 ⺣ 糸
纆 : 丷 口 土 小 幺 ⺣ 糸 里 黒
纇 : ハ 小 幺 目 米 糸 貝 頁
纊 : ハ 小 幺 广 田 糸 黄
纍 : 小 幺 田 糸
纑 : 匕 卜 厂 小 幺 田 皿 糸 虍
纕 : 一 ｜ 二 亠 口 小 幺 糸 衣
纘 : ノ 儿 ハ 土 小 幺 目 糸 貝
纚 : 一 丶 冂 匕 小 幺 广 比 糸 鹿
纝 : 小 幺 田 糸
纞 : 小 幺 心 糸 言
缼 : 人 凵 勹 山 欠 缶
缻 : 一 丶 乙 凵 山 缶
缽 : 一 凵 山 木 缶
缾 : 一 丷 凵 山 廾 缶
缿 : 一 ノ 凵 口 山 缶
罃 : 冖 凵 山 火 缶
罄 : ｜ 几 凵 又 士 尸 山 殳 缶
罇 : ハ 丷 凵 寸 山 缶 酉
罏 : 凵 匕 卜 厂 山 田 皿 缶 虍
罒 : ⺲
罓 : 丶 ノ 冂
罛 : 厶 瓜 ⺲
罜 : 丶 王 ⺲
罝 : 一 目 ⺲
罡 : 一 止 ⺲
罣 : 土 ⺲
罤 : ｜ ノ 丷 弓 ⺲
罥 : 口 月 ⺲
罦 : 子 爪 ⺲
罭 : 一 口 戈 ⺲
罱 : 一 丷 冂 十 干 ⺲
罽 : ⺉ 厂 火 ⺲
罾 : 一 ハ 丷 口 日 ⺲
罿 : 立 ⺲ 里
羀 : 一 ｜ 丶 ノ 冂 田
羋 : 一 ｜ 二 卜
羍 : 丷 大 王 羊
羏 : 丷 彡 王 羊
羐 : 一 ｜ 卜 土 夂
羑 : 丷 夂 王 羊
羖 : 丷 几 又 殳 王 羊
羗 : 乙 丷 厶 王 羊
羜 : 一 亅 丷 宀 王 羊
羡 : 人 丷 冫 勹 欠 王 羊
羢 : 一 ノ 丷 戈 王 羊
羦 : 二 儿 丷 宀 王 元 羊
羪 : 丶 丷 王 羊 艮
羭 : 一 ㅅ 丷 ⺉ 月 王 羊
羴 : 丷 王 羊
羼 : 丷 尸 王 羊
羿 : ノ 冫 廾 羽
翀 : ｜ 冫 口 羽
翃 : 一 ノ 冫 厶 羽
翈 : ｜ 冫 日 田 羽
翎 : 一 ｜ ノ 亅 ㅅ 冫 厶 羽
翏 : ㅅ 冫 彡 羽
翛 : ｜ ⺅ 冫 夂 羽
翟 : ノ 冫 羽 隹
翣 : ノ 冫 女 立 羽
翥 : 丶 ノ 冫 土 ⺹ 日 羽
翨 : 冫 日 曰 疋 羽
翬 : ノ 冖 冫 羽 車
翮 : ノ 儿 冂 冫 口 羽 鬲
翯 : ノ 亠 冂 冫 口 羽 高
翲 : ノ 二 冫 小 示 羽 西
翺 : 丶 ノ 二 冫 十 目 羽 自
翽 : 一 ノ 冫 厂 小 戈 止 羽
翾 : 一 ノ 冫 口 ⺲ 羽 衣
翿 : 一 ノ 冫 口 士 寸 工 羽
耇 : ノ 勹 口 土 ⺹
耈 : ノ 勹 匕 口 土 ⺹
耊 : 一 ノ 厶 土 ⺹ 至
耍 : 女 而
耎 : 大 而
耏 : 彡 而
耑 : 山 而
耓 : 一 ノ 亅 二 木 耒
耔 : ノ 子 木 耒
耖 : ノ 小 木 耒
耝 : 一 ノ 二 木 目 耒
耞 : ノ 力 口 木 耒
耟 : 一 ノ 二 匚 口 木 耒
耠 : 一 ノ ㅅ 口 木 耒
耤 : ｜ ノ 二 日 木 耒
耦 : ｜ ノ 冂 厶 日 木 田 ⽱ 耒
耬 : ノ 十 口 女 木 耒
耮 : ノ 冖 力 木 火 耒
耰 : 一 ノ 冖 夂 心 木 目 耒 自
耴 : 乙 耳
耵 : 一 亅 耳
耷 : 大 耳
耹 : 一 丶 ㅅ 耳
耺 : 二 厶 耳
耼 : 二 冂 月 耳
耾 : 一 ノ 厶 耳
聀 : 戈 耳
聄 : ㅅ 彡 耳
聠 : 一 丷 廾 耳
聤 : 一 亅 亠 冖 口 耳
聦 : 丶 ノ 勹 心 勿 耳
聭 : 儿 匕 厶 田 耳 鬼
聱 : 土 士 攵 方 耳
聵 : 一 ｜ ハ 口 目 耳 虫 貝
肁 : ｜ 丶 二 尸 ヨ 聿
肈 : 一 ｜ 丶 二 尸 ヨ 戈 戸 聿
肎 : 冖 月
肜 : 彡 月
肞 : 丶 ノ 又 月
肦 : ハ 冂 冫 刀 月
肧 : 一 ｜ 丶 ノ 月
肫 : ノ 乙 凵 月 屯
肸 : ハ 十 月
肹 : 一 ハ 勹 月
胈 : 又 弋 月
胍 : 厶 月 瓜
胏 : ｜ ノ 亅 月
胒 : 匕 尸 月
胔 : 入 冂 匕 止 肉
胕 : ⺅ 寸 月
胗 : ㅅ 彡 月
胘 : 亠 幺 月 玄
胠 : 厶 土 月
胭 : 囗 大 月
胮 : ｜ 二 夂 月
胰 : 大 弓 月
胲 : ノ 亠 幺 月 玄
胳 : 口 夂 月
胶 : 亠 月 父
胹 : 月 而
胺 : 女 宀 月
胾 : 入 冂 十 土 戈 肉
脃 : 乙 刀 勹 已 月 巴 色
脋 : 刀 月
脖 : 冖 十 子 月
脗 : ノ 勹 口 月 勿
脘 : 二 儿 宀 月 元
脜 : 一 月 目 自
脞 : 人 土 月
脠 : ノ 廴 月 止
脤 : 亠 厂 月 衣 辰
脧 : ハ 冂 冫 厶 夂 月
脬 : 子 月 爪
脰 : 丷 口 月 豆
脵 : 一 口 大 月
脺 : 亠 人 十 月
脼 : 一 ｜ 入 冂 月
腅 : 月 火
腇 : ノ 女 月 木 禾
腊 : ｜ 二 日 月
腌 : 乙 大 日 月 奄
腒 : 十 口 尸 月
腗 : ｜ 廾 日 月 田
腠 : 一 ノ 大 月
腡 : 冂 口 月
腧 : 一 ㅅ ⺉ 月
腨 : 山 月 而
腩 : 一 丷 冂 十 干 月
腭 : 二 勹 口 月
腯 : ノ 十 厂 月 目
腷 : 一 口 月 田
膁 : 一 ｜ 丶 ノ 丷 ヨ 月
膐 : 一 ノ 入 冂 方 氏 肉
膄 : ｜ 又 月 臼
膅 : ｜ 口 广 ヨ 月
膆 : 一 ｜ 二 小 幺 月 糸
膋 : 冖 月 火
膎 : 大 幺 月 爪
膖 : 一 ｜ 二 ⻌ 夂 月
膘 : 二 小 月 示 西
膛 : 冖 口 土 ⺌ 月
膞 : 一 十 厶 寸 日 月 虫
膢 : 十 口 女 月
膮 : 一 儿 土 月
膲 : 月 ⺣ 隹
膴 : 一 ｜ ノ 月 ⺣ 無
膻 : 一 亠 口 囗 日 月
臋 : ｜ 二 入 ハ 冂 几 又 尸 殳 肉
臃 : 亠 幺 月 隹
臅 : 勹 月 ⺲ 虫
臊 : 口 月 木
臎 : 亠 人 冫 十 月 羽
臏 : 一 ｜ ノ ハ 宀 月 目 貝
臕 : 匕 广 月 比 ⺣ 鹿
臗 : 丶 儿 宀 ⺾ 月 目 見
臛 : 二 冖 月 隹 雨
臝 : 一 丶 亠 几 口 亡 月 木 田
臞 : 月 目 隹
臡 : 入 冂 十 口 大 廾 肉 隹 革
臤 : 匚 又 臣
臫 : 乙 目 自
臬 : 木 目 自
臰 : 一 匕 夕 歹 目 自
臱 : 丷 宀 方 目 自
臲 : 勹 卩 厂 木 目 自
臵 : 一 厶 口 土 夂 至
臶 : 一 ｜ ノ 厶 土 子 至
臸 : 一 厶 土 至
臹 : 一 ノ 亅 厂 厶 土 戈 至
臽 : 勹 臼
臿 : 一 ノ 十 干 臼
舀 : 爪 臼
舃 : ⺣ 臼 鳥
舏 : ｜ 口 舌
舓 : ノ 勹 口 日 勿 舌
舔 : 一 口 大 ⺣ 舌
舙 : 口 舌
舚 : 儿 ハ 勹 厂 口 舌 言
舝 : ｜ 二 冖 厶 ユ 巛
舡 : 一 ｜ 丶 冂 工 舟
舢 : 一 ｜ 丶 冂 山 舟
舨 : 一 ｜ 丶 ノ 冂 又 舟
舲 : 一 ｜ 丶 亅 人 冂 マ 舟
舴 : 一 ｜ 丶 ノ 冂 舟
舺 : 一 ｜ 丶 冂 日 舟
艃 : 一 ｜ 丶 冂 舟 里
艄 : 一 ｜ 丶 冂 ⺌ 月 舟
艅 : 一 ｜ 丶 ㅅ 冂 小 舟
艆 : 一 ｜ 丶 冂 舟 艮
艋 : 一 ｜ 丶 冂 子 皿 舟
艎 : 一 ｜ 丶 冂 日 王 白 舟
艏 : 一 ｜ 丶 丷 冂 目 自 舟 首
艑 : 一 ｜ 丶 亅 冂 尸 戸 冊 舟 廾
艖 : 一 ｜ 丶 丷 冂 工 王 羊 舟
艜 : 一 ｜ 丶 乙 冂 冖 巾 廾 舟
艠 : 一 ｜ 丶 ノ 丷 冂 口 舟 豆
艣 : 一 ｜ 丶 冂 力 匕 卜 厂 田 舟 虍
艧 : 一 ｜ 丶 冂 又 ⺾ 舟 隹
艭 : 一 ｜ 丶 冂 又 舟 隹
艴 : 乙 勹 已 廾 弓 巴 色
艻 : 力 ⺾
艽 : 九 ⺾
艿 : 乃 ⺾
芀 : 刀 ⺾
芁 : 几 ⺾
芃 : 丶 几 ⺾
芄 : 丶 九 ⺾
芇 : ｜ 冂 巾 ⺾
芉 : 一 十 干 ⺾
芊 : 一 ノ 十 干 ⺾
芎 : 弓 ⺾
芑 : 已 ⺾
芔 : 屮 ⺾
芖 : 大 ⺾
芘 : 匕 ⺾ 比
芚 : ノ 乙 凵 ⺾ 屯
芛 : ノ ヨ ⺾
芠 : ⺾ 文
芡 : 人 勹 ⺾ 欠
芣 : 一 ｜ 丶 ノ ⺾
芤 : 乙 子 ⺾
芧 : マ ⺾ 矛
芨 : 丶 ノ 又 乃 ⺾ 及
芩 : 一 丶 ㅅ ⺾
芪 : ⺾ 氏
芮 : 人 入 冂 ⺾
芰 : 十 又 ⺾ 支
芲 : ノ 乙 ㅅ 匕 ⺾
芴 : ノ 勹 ⺾ 勿
芷 : ⺾ 止
芺 : 丶 大 ⺾
芼 : 一 ノ 乙 二 ⺾ 手
芾 : 一 ｜ 亠 冂 十 巾 ⺾
芿 : ⺅ 乃 ⺾
苆 : 一 乙 刀 匕 ⺾
苐 : ｜ ノ 弓 ⺾
苕 : 刀 口 ⺾
苚 : ｜ 二 冂 ⺾ 用
苠 : 尸 ⺾ 氏
苢 : ｜ 口 ⺾
苤 : ｜ 丶 ノ 二 ⺾
苨 : 匕 尸 ⺾
苪 : 一 人 冂 ⺾
苭 : 力 幺 ⺾
苯 : 一 ⺾ 木
苶 : ㅅ 小 ⺾
苷 : ⺾ 甘
苽 : 厶 ⺾ 瓜
苾 : ノ ⺾ 心
茀 : 廾 弓 ⺾
茁 : ｜ 凵 ⺾
茇 : 丶 ノ 又 弋 ⺾
茈 : 匕 ⺾ 止
茊 : 一 ⺾ 斤
茋 : 丶 ⺾ 氏
荔 : 力 ⺾
茛 : ⺾ 艮
茝 : 匚 ⺾ 臣
茞 : 匚 ⺾ 臣
茟 : ｜ 二 ヨ ⺾ 聿
茡 : 子 宀 ⺾
茢 : ⺉ ⺾ 歹
茬 : 一 ｜ ノ 土 ⺾
茭 : 亠 ⺾ 父
茮 : 一 卜 小 ⺾
茰 : 丶 ノ ⺾ 日
茳 : 工 ⺡ ⺾
茷 : ⺅ ⺾ 戈
茺 : 亠 儿 厶 ⺾
茼 : 一 冂 口 ⺾
茽 : ｜ ⺅ 口 ⺾
荂 : 二 勹 大 ⺾
荃 : ㅅ ⺾ 王
荄 : ノ 亠 幺 ⺾ 玄
荇 : 彳 ⺾ 行
荍 : ｜ ⺾ 攵
荎 : 一 厶 土 ⺾ 至
荑 : 大 弓 ⺾
荕 : 力 ⺾ 月
荖 : ノ 匕 土 ⺾ ⺹
荗 : 丶 ノ 厂 ⺾ 戈
荰 : 土 ⺾ 木
荸 : 冖 十 子 ⺾
荽 : 女 ⺾ 爪
荿 : ノ 亅 厂 ⺾ 戈
莀 : 亠 厂 ⺾ 衣 辰
莂 : ⺉ 力 口 ⺾
莄 : 一 丶 ノ ⺾ 日
莆 : 丶 十 ⺾ 月
莍 : 一 丶 ⺾ 水
莒 : ノ 口 ⺾
莔 : 儿 ハ 口 囗 ⺾
莕 : 口 ⺾ 木
莘 : 十 ⺾ 立 辛
莙 : ノ 口 ヨ ⺾
莛 : ノ 土 士 廴 ⺾ 王
莜 : ｜ ⺅ ⺾ 攵
莝 : 人 土 ⺾
莦 : ⺌ ⺾ 月
莧 : 儿 ⺾ 目 見
莩 : 子 ⺾ 爪
莬 : 一 ｜ 儿 勹 口 ⺾ 免
莾 : 十 大 廾 ⺾
莿 : 冂 ⺉ ⺾ 木
菀 : 卩 夕 宀 ⺾
菇 : 十 口 女 ⺾
菉 : ヨ 彑 ⺾ 水
菏 : 一 亅 口 ⺡ ⺾
菐 : 一 ｜ 丶 ノ 二 丷 大
菑 : 巛 ⺾ 田
菔 : 卩 又 ⺾ 月
菝 : 丶 ノ 又 弋 心 ⺾
荓 : 一 丷 廾 ⺾
菨 : 女 ⺾ 立
菪 : 口 宀 ⺾ 石
菶 : 一 ｜ 二 大 ⺾
菸 : 丶 ㅅ ⺾ 方
菹 : 一 ⺡ ⺾ 目
菼 : ⺾ 火
萁 : ｜ 二 ハ ⺾
萆 : ノ 十 ⺾ 日 白
萊 : 人 ⺾ 木
萏 : 勹 ⺾ 臼
萑 : ⺾ 隹
萕 : 廾 ⺾ 文
萙 : ノ 乙 冖 尢 ⺾ 木
莭 : 卩 厶 ⺾ 日
萯 : ハ 勹 ⺾ 目 貝
萹 : 一 ｜ 丶 亅 冂 尸 ⺾ 戸 冊 廾
葅 : 一 人 ⺾ 目
葇 : マ ⺾ 木 矛
葈 : 厶 口 ⺾ 木
葊 : 一 ㅅ 口 廾 ⺾
葍 : 一 口 ⺾ 田
葏 : ｜ 二 ヨ ⺡ ⺾ 聿
葑 : 土 寸 ⺾
葒 : 小 工 幺 ⺾ 糸
葖 : ハ 大 宀 ⺾
葘 : 一 巛 ⺾ 田
葙 : ⺾ 木 目
葚 : 一 儿 ハ 匚 ⺾ 目
葜 : 一 ｜ 二 刀 大 ⺾
葠 : ⺅ 冖 又 ヨ ⺾
葤 : 寸 小 幺 ⺾ 糸
葥 : 一 丷 ⺉ ⺾ 月
葧 : 冖 力 十 子 ⺾
葪 : ｜ ⺉ 勹 ⺾ 月 角
葰 : ⺅ 儿 ハ 厶 夂 ⺾
葳 : 一 ノ 厂 女 ⺾ 戈
葴 : 一 ノ 厂 口 ⺾ 戈
葶 : 一 亅 亠 冖 口 ⺾
葸 : ⺾ 心 田
葼 : 丶 ノ 儿 ハ 凵 夂 ⺾
葽 : 女 ⺾ 西
蒁 : 丶 ⻌ ⺾ 木
蒅 : 九 ⺡ ⺾ 木
蒒 : 一 ｜ ノ 冂 口 巾 ⺾
蒓 : ノ 乙 凵 小 幺 ⺾ 屯 糸
蒕 : 人 口 ⺾ 皿
蒞 : ⺅ ⺡ ⺾ 立
蒦 : 又 ⺾ 隹
蒨 : 二 亠 ⺅ 土 ⺾ 月 青
蒩 : 一 ノ ⺾ 木 目 禾
蒪 : 一 ｜ 丶 二 冂 十 寸 ⺾ 日
蒯 : 丶 冂 ⺉ ⺾ 月
蒱 : 丶 十 心 ⺾ 月
蒴 : 一 丷 屮 ⺾ 月
蒺 : 一 ノ 大 ⺾ ⽧ 矢
蒽 : 囗 大 ⺾ 心
蒾 : ⻌ ⺾ 米
蓀 : ノ 子 小 幺 ⺾ 糸
蓂 : 亠 ハ 冖 ⺾ 日
蓇 : 冂 冖 ⺾ 月 骨
蓈 : 丶 厶 ⺾ ⻏ 日
蓌 : 人 土 夂 ⺾
蓏 : 厶 ⺾ 瓜
蓓 : ⺅ 口 ⺾ 立
蓜 : 已 ⺾ 酉
蓧 : 一 ｜ ⺅ 夂 小 ⺾ 木
蓪 : マ ⻌ ⺾ 用
蓯 : 人 彳 ⺾ 止
蓰 : 彳 ⺾ 止
蓱 : 一 ノ 丷 十 干 廾 ⺡ ⺾
蓲 : 匚 口 ⺾
蓷 : 心 ⺾ 隹
蔲 : 二 儿 宀 ⺾ 攵 元
蓺 : 丶 儿 ハ 九 土 ⺾
蓻 : 一 丶 丷 十 九 土 干 ⺾
蓽 : 一 ｜ 二 ⺾ 日
蔂 : 小 幺 ⺾ 田 糸
蔃 : 口 弓 ⺾ 虫
蔇 : 厶 ⺾ 无 日 曰
蔌 : 人 勹 口 ⺾ 木 欠
蔎 : 几 又 ⺾ 殳 言
蔐 : 亠 丷 冂 十 口 ⺾ 立 啇
蔜 : 士 ⺾ 攵 方
蔞 : 十 口 女 ⺾
蔢 : ノ 十 厂 又 女 ⺡ ⺾ 支
蔣 : 丶 夕 寸 ⺾ 爿
蔤 : ノ 宀 山 ⺾ 心
蔥 : ノ 口 夂 ⺾ 心
蔧 : 一 ｜ 二 ヨ ⺾
蔪 : ⺾ 斤 車
蔫 : 一 亅 勹 ⺾ 止 ⺣
蔯 : ⺾ ⻖ 日 木
蔳 : 二 亠 土 ⺡ ⺾ 月 青
蔴 : 广 ⺾ 木 麻
蔶 : 一 ｜ 二 ハ ⺾ 目 貝
蔿 : 乃 ⺾ ⺣ 爪
蕆 : ノ ハ 厂 ⺾ 戈 目 貝
蕏 : ノ 土 ⺨ ⺾ ⺹ 日
蕐 : 一 ｜ 二 人 ⺾
蕑 : ⺾ 月 門
蕒 : ハ ⺾ 目 ⺲ 貝
蕓 : 二 冖 厶 ⺾ 雨
蕖 : 匚 口 ⺡ ⺾ 木
蕙 : 十 ⺾ 心 虫
蕜 : ⺾ 心 非
蕝 : 乙 勹 小 已 幺 ⺾ 巴 糸 色
蕞 : 又 ⺾ 日 耳
蕟 : 丶 ノ 几 又 弓 ⺾ 殳
蕠 : 口 女 小 幺 ⺾ 糸
蕡 : ハ 十 ⺾ 目 貝
蕢 : 一 ｜ ハ 口 ⺾ 目 虫 貝
蕤 : ⺾ 生 豕
蕫 : ⺾ 立 里
蕯 : ｜ ノ 二 夂 ⺾ ⻖
蕹 : 亠 幺 ⺾ 隹
蕺 : 口 ⺾ 戈 耳
蕻 : ｜ 二 ハ ⺾ 長
蕽 : ｜ 厂 ⺾ 日 衣 辰
蕿 : ノ 二 又 ⺾ 火 爪
薁 : ノ 冂 大 ⺾ 米
薅 : 厂 女 寸 ⺾ 衣 辰
薆 : 冖 夂 ⺾ 心 爪
薉 : 一 ノ 厂 小 ⺾ 戈 止
薋 : ㅅ ハ 冖 冫 勹 ⺾ 目 貝
薌 : 匕 厶 幺 ⺾ ⻏ 日 白
薏 : ⺾ 心 日 立
薓 : ｜ 冂 冖 又 巾 ヨ ⺡ ⺾
薘 : 丷 ⻌ 土 ⺾ 王 羊
薝 : 儿 ハ 勹 厂 ⺾ 言
薟 : 一 人 ㅅ 口 ⺾
薠 : ハ ⺾ 火 目 貝 頁
薢 : ｜ 刀 勹 ⺾ 月 牛 角
薥 : 勹 ⺾ ⺲ 虫
薧 : 一 亠 冖 匕 口 夕 ⺾ 歹
薴 : 一 亅 宀 ⺾ 心 皿
薶 : ⺾ 豸 里
薷 : 二 冖 ⺾ 而 雨
薸 : 二 小 ⺡ ⺾ 示 西
薼 : 匕 土 广 ⺾ 比 鹿
薽 : 一 丶 乙 二 土 ⺾ 西
薾 : 一 ｜ 冂 ⺾ 爻
薿 : 一 ノ 匕 マ 大 ⺾ 疋 矢
藂 : ｜ 丶 ノ 又 ⺾ 耳
藇 : 一 ｜ 亠 ハ ⺾ 臼
藊 : 一 ｜ 丶 ノ 亅 冂 尸 ⺾ 戸 木 禾 冊 廾
藋 : ノ 冫 ⺾ 羽 隹
藎 : 一 ｜ ヨ ⺾ ⺣ 皿
薭 : ノ 十 ⺾ 日 木 白 禾
藘 : 匕 卜 厂 ⺾ 心 田 虍
藚 : ハ 士 ⺾ 目 ⺲ 貝
藟 : ⺾ 田
藠 : ⺾ 日 白
藦 : 广 ⺾ 手 木 麻
藨 : 匕 广 ⺾ 比 ⺣ 鹿
藭 : 儿 ハ 宀 弓 ⺾ 身
藳 : ノ 亠 冂 口 ⺾ 木 禾 高
藶 : ノ 厂 ⺾ 木 止 禾
藼 : 一 ｜ 二 宀 ⺾ 心 ⺲
藿 : 二 冖 ⺾ 隹 雨
蘀 : 一 丷 十 土 干 心 ⺾ ⺲
蘄 : 十 口 ⺾ 斤 日 田
蘅 : 亅 二 勹 大 彳 ⺾ 田
蘍 : 一 ｜ ノ 丷 力 口 ⺾ ⺣
蘎 : 乙 二 冖 已 ⺾ 月 巴 雨
蘐 : ノ 二 又 ⺾ 爪 言
蘑 : 口 广 ⺾ 木 石 麻
蘒 : ノ 乙 勹 ⺾ 木 田 禾 亀
蘘 : 一 ｜ 二 亠 口 ⺾ 衣
蘙 : 一 ノ 冫 几 匚 又 大 ⺾ 殳 矢 羽
蘛 : 一 ｜ 亠 ハ 匚 厶 ⺾ 月 甘
蘞 : 一 人 ㅅ 口 ⺾ 攵
蘡 : ハ 女 ⺾ 目 貝
蘧 : 匕 卜 厂 ⻌ ⺾ 虍 豕
蘩 : 一 ノ 小 幺 ⺾ 攵 毋 母 糸
蘶 : ノ 儿 匕 厶 女 ⺾ 木 田 禾 鬼
蘸 : ⺾ ⺣ 酉 隹
蘺 : 丶 ノ 亠 冂 凵 厶 ⺾ ⽱ 隹
蘼 : 广 ⺾ 木 非 麻
蘽 : ⺾ 木 田
虀 : 一 ｜ 亠 丷 刀 ⺾ 氏 非
虂 : 二 冖 口 夂 ⺾ 足 雨
虆 : 小 幺 ⺾ 田 糸
虒 : 儿 几 匕 卜 厂 虍
虓 : 儿 几 匕 卜 厂 九 虍
虖 : 一 ノ 亅 丷 匕 卜 厂 虍
虗 : 一 匕 卜 厂 斤 虍
虘 : 一 匕 卜 厂 目 虍
虙 : ノ 匕 卜 厂 心 虍
虝 : ノ 几 勹 匕 卜 厂 勿 虍
虠 : 亠 几 匕 卜 厂 父 虍
虡 : 一 ｜ 丶 ノ ハ 匕 卜 厂 虍
虢 : 儿 几 匕 卜 厂 寸 爪 虍
虣 : 一 儿 几 匕 卜 厂 弋 止 虍
虤 : 几 匕 卜 厂 虍
虩 : 几 匕 卜 厂 小 ⺌ 日 虍
虬 : 乙 虫
虯 : ｜ 虫
虵 : ｜ 乙 匕 也 虫
虶 : 亅 二 虫
虷 : 一 十 干 虫
虺 : 一 儿 虫
蚍 : 匕 比 虫
蚑 : 十 又 支 虫
蚖 : 二 儿 元 虫
蚘 : 丶 尢 尤 虫
蚚 : 斤 虫
蚜 : 牙 虫
蚡 : ハ 刀 虫
蚦 : 二 冂 月 虫
蚧 : ｜ ノ ㅅ 虫
蚨 : 一 大 虫
蚭 : 匕 尸 虫
蚱 : 一 ｜ ノ 虫
蚳 : 一 丶 氏 虫
蚴 : 力 幺 虫
蚵 : 一 亅 口 虫
蚷 : 匚 口 虫
蚸 : 丶 斤 虫
蚹 : ⺅ 寸 虫
蚿 : 亠 幺 玄 虫
蛀 : 丶 王 虫
蛁 : 刀 口 虫
蛃 : 一 人 冂 虫
蛅 : 卜 口 虫
蛑 : 厶 牛 虫
蛒 : 口 夂 虫
蛕 : 一 ノ 月 虫
蛗 : ｜ ノ 口 虫
蛚 : ⺉ 歹 虫
蛜 : ノ ⺅ ヨ 虫
蛠 : 力 虫
蛣 : 口 士 虫
蛥 : 夕 虫
蛧 : 丶 ノ 冂 虫
蚈 : 一 廾 虫
蛺 : 人 大 虫
蛼 : 虫 車
蛽 : ハ 目 虫 貝
蜄 : 厂 虫 衣 辰
蜅 : 丶 十 月 虫
蜇 : 心 斤 虫
蜋 : 丶 艮 虫
蜎 : 口 月 虫
蜏 : ノ 乃 木 禾 虫
蜐 : 力 厶 土 虫
蜓 : ノ 土 士 廴 王 虫
蜔 : 勹 田 虫
蜙 : ハ 厶 木 虫
蜞 : ｜ 二 ハ 甘 虫
蜟 : 亠 厶 月 虫
蜡 : ｜ 二 日 虫
蜣 : 乙 儿 丷 王 羊 虫
蜨 : 土 ヨ 虫 走
蜮 : 一 口 戈 虫
蜯 : 一 ｜ 二 大 虫
蜱 : ノ 十 日 白 虫
蜲 : ノ 女 木 禾 虫
蜹 : 人 入 冂 ⺾ 虫
蜺 : 儿 臼 虫
蜼 : 虫 隹
蜽 : 一 ｜ 入 冂 虫
蜾 : 日 木 田 虫
蝀 : 日 木 虫
蝃 : 又 虫
蝅 : 一 大 虫
蝍 : 卩 厶 日 虫
蝘 : 匚 女 日 虫
蝝 : ヨ 彑 虫 豕
蝡 : 大 而 虫
蝤 : ハ 丷 虫 酉
蝥 : マ 攵 矛 虫
蝯 : ノ 二 又 爪 虫
蝱 : 亠 亡 虫
蝲 : ⺉ 口 木 虫
蝻 : 一 丷 冂 十 干 虫
螃 : 亠 丷 冖 方 立 虫
螄 : 一 ｜ ノ 冂 口 巾 虫
螅 : 心 目 自 虫
螆 : 一 丷 幺 虫
螇 : 大 幺 爪 虫
螈 : 厂 小 日 白 虫
螉 : ノ ハ 冫 厶 羽 虫
螋 : ｜ 十 又 支 臼 虫
螌 : 一 ｜ 丶 冂 几 又 殳 舟 虫
螐 : ⺣ 虫 鳥
螓 : 一 ノ 二 大 木 禾 虫
螕 : 丶 ノ 匕 口 比 虫
螗 : ｜ 口 广 ヨ 虫
螘 : 丷 口 山 虫 豆
螙 : 木 虫
螞 : 虫 馬
螠 : 一 ハ 丷 皿 虫
螣 : 一 丶 ハ 丷 冂 大 月 虫
螧 : ノ 匕 土 ⺹ 日 虫
螬 : 一 ｜ 日 虫
螭 : 丶 ノ 亠 冂 凵 厶 ⽱ 虫
螮 : 一 ｜ ノ 乙 冂 冖 巾 廾 虫
螱 : 二 寸 小 尸 示 虫
螵 : 二 小 示 虫 西
螾 : 一 ｜ ハ 宀 日 田 虫
螿 : 丶 夕 寸 爿 虫
蟁 : 尸 氏 虫
蟈 : 一 口 囗 戈 虫
蟉 : ノ ㅅ 冫 彡 羽 虫
蟊 : マ 矛 虫
蟎 : 一 ｜ 入 冂 凵 虫
蟕 : ｜ 勹 匕 月 止 虫 角
蟖 : ｜ 二 ハ 斤 甘 虫
蟙 : 戈 日 曰 立 虫
蟚 : 一 丷 十 口 士 彡 虫 豆
蟜 : ノ 冂 口 大 虫
蟟 : 丶 ノ 大 小 日 虫
蟢 : 一 丷 十 口 士 虫 豆
蟣 : 人 幺 戈 虫
蟤 : ｜ 二 已 虫
蟪 : 一 十 厶 心 日 虫
蟫 : 十 日 虫 西
蟭 : ⺣ 虫 隹
蟱 : 一 ｜ ノ ⺣ 虫 無
蟳 : 口 寸 工 ヨ 虫
蟸 : 虫 豕
蟺 : 一 亠 口 囗 日 曰 虫
蟿 : 几 凵 又 殳 虫 車
蠁 : 厶 幺 ⻏ 日 白 虫
蠃 : 丶 ノ 乙 亠 几 口 亡 月 虫
蠆 : 冂 厶 ⺾ 日 田 ⽱ 虫
蠉 : 一 口 ⺲ 虫 衣
蠊 : 一 ｜ 丶 ノ 丷 广 ヨ 虫
蠋 : 勹 ⺲ 虫
蠐 : 亠 刀 氏 虫 齊
蠙 : 一 ハ 宀 小 目 虫 貝
蠒 : 一 ｜ ハ 冂 爻 虫
蠓 : 一 冖 ⺾ 虫 豕
蠔 : 亠 冖 口 虫 豕
蠘 : 土 戈 虫 隹
蠚 : 一 ノ 口 ⺾ 虫
蠛 : 丶 ノ 厂 ⺾ 戈 ⺲ 虫
蠜 : 大 木 爻 虫
蠞 : 卩 厶 日 曰 竹 虫
蠟 : 丶 ノ 口 川 巛 虫
蠨 : ｜ ヨ ⺾ 爿 片 虫
蠭 : 一 ｜ 二 ⻌ 夂 虫
蠮 : 一 ノ 冫 几 匚 又 大 殳 矢 羽 虫
蠰 : 一 ｜ 二 亠 口 虫 衣
蠲 : 一 ハ 丷 勹 皿 ⺲ 虫
蠵 : ハ 冂 口 山 虫 隹
蠺 : 一 大 日 虫
蠼 : 又 目 虫 隹
衁 : 亠 亡 皿 血
衃 : 一 ｜ 丶 ノ 皿 血
衅 : ｜ 二 ハ 丷 皿 血
衈 : 皿 耳 血
衉 : 口 夂 皿 血
衊 : 丶 ノ 厂 ⺾ 戈 皿 ⺲ 血
衋 : 一 ｜ 二 ヨ 皿 目 聿 自 血
衎 : 一 十 干 彳 行
衑 : 丶 人 マ 彳 行
衕 : 一 冂 口 彳 行
衖 : ｜ 二 ハ 彳 行
衘 : 一 ノ 十 干 彳 止 行
衚 : 十 口 彳 月 行
衜 : 丷 彳 目 自 行 首
衟 : 一 巛 彳 目 自 行
衠 : 一 ハ 十 彳 目 行 貝
衤 : ⻂
衩 : 丶 又 ⻂
衱 : 丶 乃 及 ⻂
衹 : 氏 ⻂
衻 : 二 冂 月 ⻂
袀 : 冫 勹 ⻂
袘 : 一 ｜ ノ 乙 匕 也 ⻂
袚 : 丶 ノ 又 弋 ⻂
袛 : 一 丶 氏 ⻂
袜 : 一 木 ⻂
袟 : 一 ノ 大 ⻂
袠 : 一 ノ 亠 大 衣
袨 : 亠 幺 玄 ⻂
袪 : 厶 土 ⻂
袺 : 口 士 ⻂
袽 : 口 女 ⻂
袾 : 一 ノ 木 ⻂
裀 : 囗 大 ⻂
裊 : 亠 ⺣ 衣 鳥
裋 : 丷 口 ⻂ 豆
裌 : 人 大 ⻂
裍 : 囗 木 ⻂
裎 : ノ 口 土 王 ⻂
裑 : ⻂ 身
裒 : 亠 臼 衣
裓 : 廾 戈 ⻂
裛 : 乙 亠 口 已 ⻏ 巴 衣
裞 : 儿 丷 口 ⻂
裧 : 火 ⻂
裯 : ｜ 二 冂 口 土 ⻂
裰 : 又 ⻂
裱 : 一 ｜ 二 亠 土 ⻂ 衣
裵 : 亠 衣 非
裷 : 一 丶 ノ 丷 卩 大 已 ⻂
褁 : 日 木 田 衣
褆 : 日 疋 ⻂
褍 : 山 ⻂ 而
褎 : 一 ｜ ノ 亠 木 禾 衣
褏 : 一 ｜ 亠 日 田 衣
褕 : 一 ㅅ ⺉ 月 ⻂
褖 : ヨ 彑 ⻂ 豕
褘 : 口 ⻂ 韋
褙 : 一 ｜ 匕 月 ⻂
褚 : ノ 土 ⺹ 日 ⻂
褜 : 亠 勹 已 月 衣
褠 : 一 ｜ 二 冂 月 ⻂
褦 : 匕 厶 月 ⻂
褧 : 亠 火 耳 衣
褨 : 一 ノ 二 丷 工 王 ⻂ 羊
褰 : 一 ｜ 丶 ノ 二 亠 宀 衣
褱 : 亠 水 ⺲ 衣
褲 : 广 ⻂ 車
褵 : 丶 ノ 亠 冂 凵 厶 ⽱ ⻂
褹 : 丶 儿 ハ 九 土 ⻂
褺 : 一 丶 亠 丷 十 九 土 干 衣
褾 : 二 小 示 ⻂ 西
襀 : 一 ｜ 二 ハ 目 ⻂ 貝
襂 : ㅅ 厶 彡 ⻂
襅 : 一 ｜ 凵 ⻂ 里
襆 : 一 ｜ 丶 ノ 二 丷 大 ⻂
襉 : 月 ⻂ 門
襏 : 丶 ノ ハ 几 又 弓 殳 ⻂
襒 : ｜ 丶 ノ 丷 冂 攵 ⻂
襗 : 一 丷 十 土 干 ⻂ ⺲
襚 : ハ 丷 ⻌ ⻂ 豕
襛 : ｜ 亠 厂 日 ⻂ 衣 辰
襜 : 儿 ハ 勹 厂 ⻂ 言
襡 : 勹 ⻂ ⺲ 虫
襢 : 一 亠 口 囗 日 ⻂
襣 : 廾 田 目 ⻂ 自 鼻
襫 : 一 大 日 白 ⻂
襮 : ｜ 丶 ノ 二 日 水 ⻂
襰 : ハ 勹 口 木 目 ⻂ 貝
襳 : 一 人 戈 ⻂ 非
襵 : ⻂ 耳
襺 : ｜ 冂 小 幺 ⺾ ⻂ 糸 虫
襻 : 大 手 木 爻 ⻂
襼 : 丶 二 儿 ハ 厶 九 土 ⺾ ⻂
襽 : 丷 口 ⺾ 木 ⻂ 門
覉 : 一 亅 十 口 大 廾 西 革
覍 : 儿 小 目 見
覐 : 儿 爻 目 見
覔 : 一 ｜ 丶 ノ 儿 目 見
覕 : ノ 儿 心 目 見
覛 : 丶 ノ 儿 厂 目 見
覜 : 丶 ノ 儿 冫 目 見
覟 : 儿 士 心 目 見
覠 : ノ 儿 口 ヨ 目 見
覥 : 一 ｜ 儿 ハ 日 目 見
覰 : 儿 匕 卜 厂 目 虍 見
覴 : 丶 ノ 儿 丷 口 目 見 豆
覵 : 儿 月 目 見 門
覶 : 儿 冂 厶 又 マ 爪 目 見
覷 : 一 ｜ 丶 ノ 儿 匕 卜 厂 目 虍 見
覼 : 一 ｜ 儿 ハ 冂 爻 目 見
觔 : ｜ 力 勹 月 角
觕 : ｜ 勹 月 牛 角
觖 : ｜ 人 勹 ユ 月 角
觗 : ｜ 勹 月 氏 角
觘 : ｜ ノ 勹 小 月 角
觥 : 一 ｜ 儿 勹 ⺌ 月 角
觩 : 一 ｜ 丶 勹 月 水 角
觫 : ｜ 勹 口 月 木 角
觭 : 一 ｜ 亅 勹 口 大 月 角
觱 : 一 ｜ ノ 勹 厂 口 戈 月 角
觳 : 一 ｜ 冖 几 勹 又 士 月 殳 角
觶 : ｜ 勹 十 口 日 月 田 角
觹 : ｜ 亅 勹 月 角 隹
觽 : ｜ 亅 勹 山 月 角 隹
觿 : ｜ 儿 ハ 冂 勹 口 山 月 角 隹
訄 : 九 言
訅 : 九 言
訇 : 勹 言
訏 : 亅 二 言
訑 : ｜ 乙 匕 也 言
訒 : ノ 刀 言
訔 : 山 言
訕 : 山 言
訞 : ノ 大 言
訠 : ｜ 弓 言
訢 : 斤 言
訤 : 爻 言
訦 : ノ 乙 冖 尢 言
訫 : 心 言
訬 : ノ 小 言
訯 : 丶 乃 及 言
訵 : 儿 囗 言
訷 : ｜ 日 言
訽 : 勹 口 言
訾 : 匕 止 言
詀 : 卜 口 言
詃 : 亠 幺 玄 言
詅 : 一 丶 亅 ㅅ マ 言
詇 : 口 大 言
詉 : 又 女 言
詍 : 一 ｜ 世 言
詎 : 匚 口 言
詓 : 厶 土 言
詖 : ノ 十 厂 又 支 言
詗 : 冂 口 言
詘 : ｜ 凵 言
詜 : ｜ 凵 又 屮 言
詝 : 一 亅 宀 言
詡 : ノ 冫 羽 言
詥 : 一 ㅅ 口 言
詧 : 丶 夕 言
詵 : 一 ノ 儿 土 言
詶 : 丶 川 言
詷 : 一 冂 口 言
詹 : 儿 ハ 勹 厂 言
詺 : 口 夕 言
詻 : 口 夂 言
詾 : 丶 ノ 凵 勹 言
詿 : 土 言
誀 : 耳 言
誃 : 夕 言
誆 : 匚 王 言
誋 : 已 心 言
誏 : 丶 艮 言
誐 : 戈 手 言
誒 : 一 ノ 厶 大 矢 言
誖 : 冖 十 子 言
誗 : ノ ⺉ 木 禾 言
誙 : 一 巛 工 言
誟 : ノ 土 子 ⺹ 言
誧 : 丶 十 月 言
誩 : 言
誮 : ノ 乙 ⺅ 匕 ⺾ 言
誯 : 日 曰 言
誳 : ｜ 凵 尸 言
誶 : 亠 人 十 言
誷 : 一 亠 丷 冂 亡 言
誻 : 日 曰 水 言
誾 : 言 門
諃 : 木 言
諆 : ｜ 二 ハ 言
諈 : 一 ｜ ノ 言
諉 : ノ 女 木 禾 言
諊 : 勹 米 言
諑 : 丶 言 豕
諓 : 戈 言
諔 : 一 卜 又 小 言
諕 : 几 匕 卜 厂 虍 言
諗 : 一 丶 ㅅ 心 言
諝 : 月 疋 言
諟 : 日 疋 言
諬 : 丶 ノ 尢 木 尤 禾 言
諰 : 心 田 言
諴 : 一 ノ 厂 口 戈 言
諵 : 一 丷 冂 十 干 言
諶 : 一 ｜ 儿 ハ 匚 言
諼 : ノ 二 又 爪 言
諿 : 口 耳 言
謅 : 勹 屮 言
謆 : 一 丶 ノ 冫 尸 戸 羽 言
謋 : 夕 木 言 舛
謑 : 大 幺 爪 言
謜 : 厂 小 日 白 言
謞 : 亠 冂 口 言 高
謟 : 爪 臼 言
謊 : ｜ ノ 乙 亠 川 ⺾ 亡 言
謭 : 一 丷 刀 ⺉ 月 言
謰 : ⻌ 言 車
謷 : 土 士 攵 方 言
謼 : 一 ノ 亅 丷 匕 卜 厂 虍 言
譂 : ｜ 口 日 田 言
譃 : 一 ｜ 丶 ノ 匕 卜 厂 虍 言
譄 : ｜ ハ 丷 口 日 言
譅 : 丶 刀 止 言
譆 : 一 丷 十 口 士 言 豆
譈 : 亠 口 子 攵 言
譒 : ノ 田 米 言
譓 : 一 心 虫 言
譔 : ｜ 二 ハ 已 言
譙 : ⺣ 言 隹
譍 : ⺅ 广 言 隹
譞 : 一 口 ⺲ 衣 言
譣 : 一 人 ㅅ 口 言
譭 : 几 又 工 殳 臼 言
譶 : 言
譸 : 一 口 士 寸 工 言
譹 : 亠 冖 口 言 豕
譼 : 一 丶 ノ 匚 ⺲ 臣 言
譾 : 一 丶 ノ 丷 冂 冫 ⺉ 月 羽 言
讁 : 亠 丷 冂 十 ⻌ 口 立 言 啇
讄 : 田 言
讅 : ノ 宀 田 米 言
讋 : 乙 月 立 言 竜
讍 : 口 王 言
讏 : 一 ｜ 冂 ユ 口 巾 彳 行 言
讔 : 工 ヨ ⻖ 心 爪 言
讕 : 丷 口 木 言 門
讜 : 丷 冖 口 ⺌ ⺣ 言 里 黒
讞 : 丶 儿 冂 匕 卜 厂 口 大 犬 虍 言 鬲
讟 : ハ 士 目 ⺲ 言 貝
谸 : 一 ノ ㅅ ハ 口 谷
谹 : 一 ノ ㅅ ハ 厶 口 谷
谽 : 一 丶 ㅅ ハ 口 谷
谾 : ㅅ ハ 口 宀 工 谷
豅 : 乙 ㅅ ハ 口 月 立 谷 竜
豇 : 丷 口 工 豆
豉 : 丷 十 又 口 支 豆
豋 : 丶 丷 口 夕 豆
豏 : 一 ｜ 丶 ノ 丷 口 ヨ 豆
豑 : ｜ ノ 丷 口 弓 日 豆
豓 : 一 ｜ 丶 丷 口 大 山 皿 豆
豔 : 一 ｜ 丷 厶 口 土 山 皿 豆
豗 : 一 儿 豕
豘 : ノ 乙 凵 屯 豕
豛 : 几 又 殳 豕
豝 : 乙 已 巴 豕
豙 : 亠 丷 立 豕
豣 : 一 ノ 二 十 干 豕
豤 : 艮 豕
豦 : 匕 卜 厂 虍 豕
豨 : 一 ｜ 丶 ノ 冂 巾 豕
豩 : 豕
豭 : 一 ｜ 又 口 豕
豳 : 山 豕
豵 : 人 彳 止 豕
豶 : ハ 十 ⺾ 目 豕 貝
豻 : 一 十 干 豸
豾 : 一 ｜ 丶 ノ 豸
貆 : 一 日 豸
貇 : 艮 豸
貋 : 一 十 干 日 曰 豸
貐 : 一 ㅅ ⺉ 月 豸
貒 : 山 而 豸
貓 : ⺾ 田 豸
貙 : 匚 口 豸
貛 : 口 ⺾ 豸 隹
貜 : 又 目 豸 隹
貤 : ｜ 乙 ハ 匕 也 目 貝
貹 : ハ 生 目 貝
貺 : 儿 ハ 口 目 貝
賅 : ノ 亠 ハ 幺 玄 目 貝
賆 : 一 ハ 丷 廾 目 貝
賉 : ハ 皿 目 血 貝
賋 : 亠 ハ 父 目 貝
賏 : ハ 目 貝
賖 : 二 ㅅ ハ 小 目 貝
賕 : 一 丶 ハ 水 目 貝
賙 : ｜ 二 ハ 冂 口 土 目 貝
賝 : ハ 冖 木 目 貝
賡 : 丶 ノ ハ 广 ヨ 目 貝
賨 : 二 ハ 宀 小 目 示 貝
賬 : ハ 目 貝 長
賯 : ハ 勹 子 日 曰 目 貝
賰 : 一 二 ハ 大 日 目 貝
賲 : ⺅ ハ 口 木 目 貝
賵 : 二 ハ 冂 目 貝
賷 : ハ 冖 十 口 目 貝
賸 : 一 ハ 丷 大 月 目 貝
賾 : 一 ｜ 二 ハ 匚 目 臣 貝
賿 : ㅅ ハ 冫 彡 目 羽 貝
贁 : ハ 攵 目 貝
贃 : ｜ ハ 口 心 目 貝
贉 : 一 ｜ ハ 凵 十 日 目 西 貝
贒 : ｜ ハ 匚 口 心 目 臣 貝
贗 : ⺅ ハ 厂 ⺣ 目 貝 鳥
贛 : ハ 十 夂 工 日 目 立 貝
赥 : 人 勹 土 欠 赤
赩 : 乙 勹 土 已 巴 色 赤
赬 : ハ 卜 土 目 貝 赤
赮 : ｜ 又 口 土 赤
赿 : 土 氏 走
趂 : 勹 土 小 走
趄 : 土 目 赤
趈 : 卜 口 土 走
趍 : 土 夕 走
趐 : 冫 土 羽 走
趑 : 人 冫 勹 土 欠 走
趕 : 一 十 土 干 日 走
趞 : ｜ 二 土 日 曰 走
趟 : 冂 口 土 ⺌ 走
趠 : 十 卜 土 日 曰 走
趦 : 人 冫 勹 口 土 欠 走
趫 : ノ 冂 口 土 大 走
趬 : 一 儿 土 走
趯 : ノ 冫 土 羽 走 隹
趲 : ノ 儿 ハ 土 目 貝 走
趵 : 丶 勹 口 止 足
趷 : 一 ノ 乙 口 止 足
趹 : 人 ユ 口 止 足
趻 : 丶 ㅅ 口 止 足
跀 : 口 月 止 足
跅 : 丶 口 斤 止 足
跆 : 厶 口 止 足
跇 : 一 ｜ 口 止 世 足
跈 : ㅅ 口 彡 止 足
跊 : 一 口 木 止 足
跎 : 匕 口 宀 止 足
跑 : 勹 口 已 止 足
跔 : 勹 口 止 足
跕 : 卜 口 止 足
跗 : ⺅ 口 寸 止 足
跙 : 一 口 止 目 足
跤 : 亠 口 止 父 足
跥 : 乃 口 木 止 足
跧 : ㅅ 口 止 王 足
跬 : 口 土 止 足
跰 : 一 丷 口 廾 止 足
趼 : 一 口 廾 止 足
跱 : 口 土 寸 止 足
跲 : 一 人 口 止 足
跴 : 口 止 西 足
跽 : 口 已 心 止 足
踁 : 一 口 巛 工 止 足
踄 : ノ 口 小 止 足
踅 : 口 心 斤 足
踆 : 儿 ハ 厶 口 夂 止 足
踋 : 卩 厶 口 土 止 足
踑 : ｜ 二 ハ 口 止 甘 足
踔 : 十 卜 口 日 止 足
踖 : ｜ 二 口 日 止 足
踠 : 卩 口 夕 宀 已 止 足
踡 : 一 ハ 丷 卩 口 大 已 止 足
踢 : ノ 勹 口 日 止 勿 足
踣 : 口 止 立 足
踦 : 一 亅 口 大 止 足
踧 : 又 口 土 小 足
踱 : 一 凵 又 口 广 止 足
踳 : 一 二 口 大 日 止 足
踶 : 口 日 止 疋 足
踷 : ノ 口 土 ⺹ 日 曰 止 足
踸 : 一 ｜ ハ 匚 口 止 甘 足
踹 : 口 山 止 而 足
踽 : ノ 冂 厶 口 止 ⽱ 虫 足
蹀 : 一 ｜ 口 木 止 世 足
蹁 : 一 ｜ 丶 亅 冂 口 尸 廾 戸 止 冊 足
蹋 : ノ 冫 口 日 止 羽 足
蹍 : ｜ 二 口 尸 止 衣 足
蹎 : ハ 十 口 止 目 貝 足
蹏 : ノ 儿 几 匕 卜 厂 口 止 虍 足
蹔 : 口 斤 足 車
蹛 : 一 ｜ ノ 乙 冂 冖 口 巾 廾 止 足
蹜 : 一 ⺅ 口 宀 日 止 白 足
蹝 : 口 彳 止 足
蹞 : ハ 卜 口 止 目 貝 足 頁
蹡 : 丶 口 夕 寸 止 爿 足
蹢 : 亠 丷 冂 十 口 止 立 足
蹩 : ｜ ハ 丷 冂 口 巾 攵 足
蹬 : 丶 ノ 丷 口 止 豆 足
蹭 : ｜ ハ 丷 口 日 止 足
蹯 : ノ 口 止 田 米 足
蹰 : 丷 厂 口 寸 止 豆 足
蹱 : 口 止 立 足 里
蹹 : 一 ㅅ 冫 口 止 羽 足
蹺 : 一 儿 口 土 止 足
蹻 : ノ 冂 口 大 止 足
躂 : 丷 ⻌ 口 土 止 王 羊 足
躃 : 十 口 尸 止 立 足 辛
躉 : 冂 厶 口 ⺾ 田 ⽱ 足
躐 : 丶 ノ 乙 口 川 巛 止 足
躒 : 口 幺 日 木 止 白 足
躕 : 丷 十 口 士 寸 广 止 豆 足
躚 : 一 凵 ⻌ 口 大 已 止 西 足
躛 : 一 ｜ 冂 ユ 口 巾 彳 行 足
躝 : 丷 口 木 止 足 門
躞 : 又 口 止 火 言 足
躢 : 冫 口 日 曰 止 羽 足 門
躧 : 一 丶 冂 匕 口 广 止 比 足 鹿
躩 : 又 口 止 目 足 隹
躭 : ノ 乙 冖 尢 身
躮 : ハ 刀 身
躳 : ノ 口 身
躵 : ノ 刀 心 身
躺 : 冂 口 ⺌ 身
躻 : 儿 ハ 宀 工 身
軀 : 匚 口 身
軁 : 十 口 女 身
軃 : 十 口 日 田 身
軄 : 戈 日 立 身 音
軇 : 一 口 士 寸 工 身
軏 : 一 儿 車
軑 : 大 車
軔 : ノ 刀 車
軜 : 人 冂 車
軨 : 一 ｜ 丶 亅 ㅅ マ 車
軮 : 口 大 車
軰 : 一 ｜ 匕 車
軱 : 厶 瓜 車
軷 : 又 弋 車
軹 : ハ 口 車
軺 : 刀 口 車
軭 : 匚 王 車
輀 : 而 車
輂 : ｜ 二 ハ 車
輇 : ㅅ 王 車
輈 : 一 ｜ 丶 冂 舟 車
輏 : 車 酉
輐 : 二 儿 宀 元 車
輖 : 冂 口 土 車
輗 : 儿 臼 車
輘 : 儿 ハ 土 夂 車
輞 : 一 亠 丷 冂 亡 車
輠 : 木 田 車
輡 : 勹 臼 車
輣 : 月 車
輥 : 匕 日 比 車
輧 : 一 ノ 十 干 車
輨 : ｜ 口 宀 車
輬 : 亠 口 小 車
輭 : 大 而 車
輮 : マ 木 矛 車
輴 : 十 厂 目 車
輵 : 人 勹 日 車
輶 : ハ 丷 車 酉
輷 : 勹 言 車
輺 : 一 巛 田 車
轀 : 人 口 皿 車
轁 : 爪 臼 車
轃 : 一 ノ 二 大 木 禾 車
轇 : ノ ㅅ 冫 彡 羽 車
轏 : 子 尸 車
轑 : 丶 ノ 大 小 日 車
轒 : ハ 十 ⺾ 目 貝 車
轓 : ノ 田 米 車
轔 : 夕 米 車 舛
轕 : 人 勹 ⺾ 日 車
轘 : 一 口 ⺲ 衣 車
轝 : 一 ｜ 亠 ハ ヨ 車
轞 : 一 丶 ノ 匚 皿 臣 車
轥 : ⺾ 車 門 隹
辝 : 十 厶 口 立 辛
辠 : 十 目 立 自 辛
辡 : 十 立 辛
辤 : 冖 十 又 爪 立 辛
辥 : ｜ ノ 十 口 屮 立 辛
辦 : 力 十 立 辛
辵 : 彡 止
辶 : ⻌
辸 : 乃 ⻌
达 : ⻌ 大
迀 : 一 十 ⻌ 干
迁 : ノ 十 ⻌
迆 : ｜ 乙 匕 ⻌ 也
迊 : 一 ｜ 冂 ⻌ 巾
迋 : ⻌ 王
迍 : ノ 乙 凵 ⻌ 屯
运 : 二 厶 ⻌
迒 : 亠 几 ⻌
迓 : ⻌ 牙
迕 : 一 ノ 十 ⻌ 干
迠 : 卜 ⻌ 口
迣 : 一 ｜ ⻌ 世
迤 : 一 ｜ ノ 乙 匕 ⻌ 也
迨 : 厶 ⻌ 口
迮 : 一 ｜ ノ ⻌
迱 : 匕 ⻌ 宀
迵 : 一 冂 ⻌ 口
迶 : 一 ノ ⻌ 月
迻 : ⻌ 夕
迾 : ⺉ ⻌ 歹
适 : ⻌ 口 舌
逄 : ｜ 二 ⻌ 夂
逈 : ノ 冂 ⻌ 口
逌 : 卜 ⻌ 口
逘 : 一 ノ 厶 ⻌ 大 矢
逛 : ⻌ ⺨ 王
逨 : 人 ⻌ 木
逩 : 十 ⻌ 大 廾
逯 : ⻌ ヨ 彑 水
逪 : ｜ 二 ⻌ 日
逬 : 一 ノ 十 ⻌ 干
逭 : ｜ ⻌ 口 宀
逳 : 亠 厶 ⻌ 月
逴 : 十 卜 ⻌ 日
逷 : ノ 勹 ⻌ 日 勿
逿 : 一 ノ 勹 ⻌ 日 曰 勿
遃 : 丶 ノ 亠 丷 厂 ⻌ 彡
遄 : ⻌ 山 而
遌 : 二 勹 ⻌ 口
遛 : 刀 厶 ⻌ 田
遝 : ｜ 丶 ノ ⻌ ⺲
遢 : 冫 ⻌ 日 曰 羽
遦 : ハ 十 ⻌ 口 田 目 貝
遧 : 十 ⻌ 日 立
遬 : 人 勹 ⻌ 口 木 欠
遰 : 一 ｜ ノ 乙 冂 冖 ⻌ 巾 廾
遴 : ⻌ 夕 米 舛
遹 : 儿 ハ 冂 マ ⻌ 口 矛
邅 : 一 亠 ⻌ 口 日
邈 : 儿 ⻌ 日 白 豸
邋 : 丶 ノ 乙 ⻌ 口 川 巛
邌 : ノ ㅅ 勹 ⻌ 木 水 禾
邎 : 丶 ノ ⻌ 夕 小 幺 糸 言
邐 : 一 丶 冂 匕 ⻌ 广 比 鹿
邕 : 乙 口 巛 已 ⻏ 巴
邗 : 一 十 干 ⻏
邘 : 亅 二 ⻏
邙 : 亠 ⻏ 亡
邛 : 工 ⻏
邠 : ハ 刀 ⻏
邡 : ⻏ 方
邢 : 一 廾 ⻏
邥 : ノ 乙 冖 尢 ⻏
邰 : 厶 口 ⻏
邲 : ノ ⻏ 心
邳 : 一 ｜ 丶 ノ ⻏
邴 : 一 人 冂 ⻏
邶 : 一 ｜ 匕 ⻏
邽 : 土 ⻏
郌 : 乙 口 士 已 ⻏ 巴
邾 : 一 ノ ⻏ 木
郃 : 一 ㅅ 口 ⻏
郄 : 一 丶 ノ 厶 ⻏
郅 : 一 厶 土 ⻏ 至
郇 : 勹 ⻏ 日
郈 : 一 厂 口 ⻏
郕 : ノ 亅 厂 ⻏ 戈
郗 : 一 ｜ 丶 ノ 冂 巾 ⻏
郘 : 口 ⻏
郙 : 丶 十 ⻏ 月
郜 : ｜ ノ 二 口 土 ⻏
郝 : 土 ⻏ 赤
郟 : 人 大 ⻏
郥 : ハ ⻏ 目 貝
郒 : 丶 乙 厶 口 已 ⻏ 日 曰 巴
郶 : 乙 口 已 ⻏ 巴 立
郫 : ノ 十 ⻏ 日 白
郯 : ⻏ 火
郰 : 又 ⻏ 耳
郴 : ⻏ 木
郾 : 匚 女 ⻏ 日
郿 : ｜ 尸 ⻏ 目
鄀 : 一 ノ 口 ⺾ ⻏
鄄 : 土 ⻏ 西
鄅 : ノ 冂 厶 口 ⻏ ⽱ 虫
鄆 : 冖 ⻏ 車
鄈 : 一 丶 ノ 大 ⻏
鄍 : 亠 ハ 冖 ⻏ 日 曰
鄐 : 亠 幺 ⻏ 玄 田
鄔 : ⻏ ⺣ 鳥
鄖 : ハ 口 ⻏ 目 貝
鄗 : 亠 冂 口 ⻏ 高
鄘 : ｜ 二 冂 广 ヨ ⻏ 月 聿
鄚 : 大 ⺾ ⻏ 日
鄜 : 匕 广 ⻏ 比 鹿
鄞 : 二 十 口 廾 ⻏ 革
鄠 : 二 冖 勹 ⻏ 雨
鄥 : ⻏ ⺣ 鳥
鄢 : 一 勹 ⻏ 止 ⺣
鄣 : 十 ⻏ 日 立 音
鄧 : 丶 ノ 丷 口 ⻏ 豆
鄩 : 口 寸 工 ヨ ⻏
鄮 : ノ ハ 刀 厶 ⻏ 目 貝
鄯 : 一 丷 口 ⻏ 王 羊
鄱 : ノ ⻏ 田 米
鄴 : 一 ｜ 丶 ノ 丷 ⻏ 王 羊
鄶 : 一 ｜ ㅅ 丷 口 ⻏ 日 曰
鄷 : ｜ 丷 口 ⻏ 日 豆
鄹 : ｜ 丶 ノ 又 ⻏ 耳
鄺 : ハ 广 ⻏ 田 黄
鄼 : 一 ハ 大 ⻏ 目 貝
鄽 : 儿 ハ 土 广 ⻏ 里
酃 : 二 冖 口 ⻏ 雨
酇 : ノ 儿 ハ 土 ⻏ 目 貝
酈 : 一 丶 冂 匕 广 ⻏ 比 鹿
酏 : ｜ 乙 匕 也 酉
酓 : 丶 ㅅ 酉
酗 : 丶 ノ 凵 酉
酙 : 斗 酉
酚 : ハ 刀 酉
酛 : 二 儿 元 酉
酡 : 匕 宀 酉
酤 : 十 口 酉
酧 : 宀 寸 酉
酭 : 一 ノ 月 酉
酴 : 二 ㅅ 小 酉
酹 : 寸 爪 酉
酺 : 丶 十 月 酉
酻 : 子 爪 酉
醁 : ヨ 水 酉
醃 : 乙 大 日 酉 奄
醅 : 口 立 酉
醆 : 戈 酉
醊 : 又 酉
醎 : 一 ノ 厂 口 戈 酉
醑 : 月 疋 酉
醓 : ノ 乙 冖 尢 皿 酉
醔 : ノ 木 火 禾 酉
醕 : 亠 口 日 酉
醘 : 厶 土 皿 酉
醞 : 人 口 皿 酉
醡 : 一 ｜ ノ 亠 ハ 酉
醦 : ㅅ 厶 彡 酉
醨 : 丶 ノ 亠 冂 凵 厶 ⽱ 酉
醬 : 丶 夕 寸 爿 酉
醭 : 一 ｜ 丶 ノ 二 丷 大 酉
醮 : ⺣ 酉 隹
醰 : 一 冂 凵 十 日 西 酉
醱 : 丶 ノ 几 又 弓 殳 酉
醲 : ｜ 厂 日 衣 辰 酉
醳 : 一 丷 十 土 干 ⺲ 酉
醶 : 一 人 ㅅ 口 酉
醻 : 一 口 士 寸 工 酉
醼 : 一 ｜ 凵 匕 口 ⺣ 酉
醽 : 二 冖 口 酉 雨
醿 : 小 幺 广 木 糸 酉 麻
釂 : 一 ｜ 厶 寸 日 爪 ⺲ 酉
釃 : 一 丶 冂 匕 广 比 酉 鹿
釅 : 厂 口 工 攵 耳 酉
釓 : 乙 金
釔 : 乙 金
釗 : ⺉ 金
釙 : 卜 金
釚 : 九 金
釞 : 入 金
釤 : 彡 金
釥 : 小 金
釩 : 丶 几 金
釪 : 亅 二 金
釬 : 一 十 干 金
釭 : 工 金
釮 : 一 ノ 亅 金
釯 : 亠 亡 金
釰 : ノ 刀 金
釱 : 大 金
釷 : 土 金
釹 : 女 金
釻 : 丶 九 金
釽 : 爪 金
鈀 : 乙 已 巴 金
鈁 : 方 金
鈄 : 斗 金
鈅 : 月 金
鈆 : ハ 厶 金
鈇 : 一 大 金
鈉 : 人 入 冂 金
鈊 : 心 金
鈌 : 人 ユ 金
鈐 : 一 丶 ㅅ 金
鈒 : 丶 乃 及 金
鈓 : ノ 士 金
鈖 : ハ 刀 金
鈘 : 十 又 支 金
鈜 : 一 ノ 厶 金
鈝 : 牛 金
鈣 : 一 亅 止 金
鈤 : 日 曰 金
鈥 : 火 金
鈦 : 丶 大 金
鈨 : 二 儿 元 金
鈮 : 匕 尸 金
鈯 : ｜ 凵 金
鈰 : ｜ 亠 冂 巾 金
鈳 : 一 亅 口 金
鈵 : 一 人 冂 金
鈶 : 厶 口 金
鈸 : 又 弋 金
鈹 : ノ 十 又 支 金
鈺 : 丶 王 金
鈼 : 一 ｜ ノ 金
鈾 : ｜ 日 田 金
鉀 : ｜ 日 田 金
鉂 : 丶 ノ 口 金
鉃 : 一 ノ 大 矢 金
鉆 : 卜 口 金
鉇 : 一 ｜ ノ 乙 匕 也 金
鉊 : 刀 口 金
鉍 : ノ 心 金
鉎 : 生 金
鉏 : 一 目 金
鉑 : 日 白 金
鉘 : 廾 弓 金
鉙 : ハ 口 金
鉜 : ⺅ 寸 金
鉝 : 立 金
鉠 : 口 大 金
鉡 : ｜ 二 ハ 丷 金
鉥 : 丶 ノ 乙 十 木 金
鉧 : 毋 母 金
鉨 : 勹 小 金
鉩 : ㅅ 小 金
鉮 : ｜ 日 田 金
鉯 : 丶 人 金
鉰 : 一 亅 口 金
鉵 : 虫 金
鉶 : 一 ⺉ 廾 金
鉷 : ｜ 二 ハ 金
鉸 : 亠 父 金
鉹 : 夕 金
鉻 : 口 夂 金
鉼 : 一 丷 廾 金
鉽 : 工 弋 金
鉿 : 一 ㅅ 口 金
銈 : 土 金
銉 : ｜ 二 ヨ 聿 金
銊 : 一 ノ 厂 戈 金
銍 : 一 厶 土 至 金
銎 : 丶 几 工 金
銒 : 一 十 干 金
銗 : 一 ノ 厂 口 金
銙 : 一 勹 大 金
銟 : ｜ 冂 山 巾 金
銠 : ノ 匕 土 ⺹ 金
銤 : 米 金
銥 : 亠 衣 金
銧 : 一 儿 ⺌ 金
銨 : 女 宀 金
銫 : 乙 勹 已 巴 色 金
銯 : 小 幺 糸 金
銲 : 一 十 干 日 金
銶 : 一 丶 水 金
銸 : 乙 耳 金
銺 : 士 爿 金
銻 : ｜ ノ 丷 弓 金
銼 : 人 土 金
銽 : 口 氏 金
銿 : マ 用 金
鋀 : 丷 口 豆 金
鋁 : 口 金
鋂 : 一 ノ 毋 母 金
鋃 : 丶 艮 金
鋅 : 十 立 辛 金
鋆 : 二 冫 勹 土 金
鋇 : ハ 目 貝 金
鋈 : ノ 大 ⺡ 金
鋋 : ノ 廴 止 金
鋌 : ノ 土 士 廴 王 金
鋍 : 冖 十 子 金
鋎 : 二 儿 宀 元 金
鋐 : 一 ノ 厶 宀 金
鋓 : ノ ⺉ 木 禾 金
鋕 : 士 心 金
鋗 : 口 月 金
鋘 : 一 口 大 金
鋙 : 一 二 口 五 金
鋜 : 口 足 金
鋝 : 寸 爪 金
鋟 : 冖 又 ヨ 金
鋠 : 亠 厂 衣 辰 金
鋡 : 丶 ㅅ 口 金
鋣 : ⻏ 牙 金
鋥 : 口 王 金
鋧 : 儿 目 見 金
鋨 : 戈 手 金
鋬 : 厂 又 心 金
鋮 : ノ 亅 厂 戈 金
鋰 : 里 金
鋹 : 金 長
鋻 : 匚 又 臣 金
鋿 : 冂 口 ⺌ 金
錀 : 一 ｜ 亅 ㅅ 冂 冊 金 廾
錂 : 儿 ハ 土 夂 金
錈 : 一 丶 ノ 二 丷 大 已 金
錍 : ノ 十 日 白 金
錑 : 一 丶 大 尸 戸 犬 金
錔 : 日 水 金
錕 : 匕 日 比 金
錜 : 丶 ㅅ 心 金
錝 : 二 宀 小 示 金
錞 : 亠 口 子 金
錟 : 火 金
錡 : 一 亅 口 大 金
錤 : ｜ 二 ハ 甘 金
錥 : 亠 厶 月 金
錧 : ｜ 口 宀 金
錩 : 日 金
錪 : ｜ ハ 日 金
錳 : 子 皿 金
錴 : ハ 土 金
錶 : 一 ｜ 二 衣 金
錷 : 乙 車 金
鍇 : 匕 日 比 白 金
鍈 : 口 大 ⺾ 金
鍉 : 日 疋 金
鍐 : 丶 ノ ハ 凵 夂 金
鍑 : 一 ノ 夂 日 金
鍒 : マ 木 矛 金
鍕 : 冖 車 金
鍗 : ｜ 亠 丷 冂 冖 巾 立 金
鍘 : ハ ⺉ 目 貝 金
鍚 : 一 ノ 勹 日 勿 金
鍞 : ハ 卜 目 貝 金
鍤 : ノ 十 臼 金
鍥 : 一 ｜ 二 刀 大 金
鍧 : 勹 言 金
鍩 : 一 ノ 口 ⺾ 金
鍪 : マ 攵 矛 金
鍭 : 一 ノ ⺅ ユ 大 矢 金
鍯 : 丶 ノ 勹 心 勿 金
鍰 : ノ 二 又 爪 金
鍱 : 一 ｜ 木 世 金
鍳 : 一 丶 ノ 匚 臣 金
鍴 : 山 而 金
鍶 : 心 田 金
鍺 : ノ 土 ⺹ 日 曰 金
鍽 : 一 ｜ 丶 亅 冂 尸 戸 冊 金 廾
鍿 : 一 巛 田 金
鎀 : ｜ ⺅ 夂 彡 金
鎁 : ⻏ 耳 金
鎂 : 丷 大 王 金
鎈 : ノ 丷 工 王 羊 金
鎊 : 亠 丷 冖 方 立 金
鎋 : 一 ｜ ノ 二 口 宀 金
鎍 : 冖 十 小 幺 糸 金
鎏 : ｜ ノ 乙 亠 厶 川 ⺡ 金
鎒 : 亠 厂 寸 衣 辰 金
鎕 : ｜ 口 广 ヨ 金
鎘 : 儿 冂 口 金 鬲
鎛 : 丶 十 寸 日 金
鎞 : 丶 ノ 匕 口 比 金
鎡 : 一 丷 幺 金
鎣 : 冖 火 金
鎤 : 一 儿 ⺌ 日 金
鎦 : ノ 刀 厶 田 金
鎨 : 十 金 隹
鎫 : 丶 ノ ハ 冂 夂 金
鎴 : 心 目 自 金
鎵 : 宀 豕 金
鎶 : 一 亅 口 金
鎺 : 一 ⺭ 目 金
鎩 : 一 几 又 小 殳 金
鏁 : 巛 日 木 田 金
鏄 : 一 十 厶 寸 日 虫 金
鏅 : ｜ ⺅ 夂 月 金
鏆 : ハ 十 口 田 目 貝 金
鏇 : 一 ノ 方 疋 金
鏉 : 人 勹 口 木 欠 金
鏊 : 一 ｜ ノ 亅 二 土 士 攵 方 金
鏋 : 一 ｜ 入 冂 凵 金
鏌 : 大 ⺾ 日 金
鏍 : 小 幺 田 糸 金
鏓 : ノ 口 夂 心 金
鏙 : 山 金 隹
鏜 : 冖 口 土 ⺌ 金
鏞 : ｜ 二 冂 广 ヨ 月 聿 金
鏟 : 亠 丷 厂 生 立 金
鏢 : 二 小 示 西 金
鏦 : 人 彳 止 金
鏧 : ｜ 几 又 士 尸 殳 金
鏹 : 厶 口 弓 虫 金
鏷 : 一 ｜ 丶 ノ 二 人 丷 大 王 金
鏸 : 一 十 厶 心 日 虫 金
鏺 : 丶 ノ 几 又 弓 殳 金
鏻 : 夕 米 舛 金
鏽 : ｜ ヨ 爿 片 金
鐁 : ｜ 二 ハ 斤 甘 金
鐂 : 一 ｜ 田 金
鐄 : ハ 田 金 黄
鐈 : ノ 冂 口 大 金
鐉 : ｜ 二 ハ 已 金
鐍 : 儿 ハ 冂 マ 口 矛 金
鐎 : ⺣ 金 隹
鐏 : ハ 丷 寸 酉 金
鐕 : 无 日 曰 金
鐖 : 人 幺 戈 金
鐗 : 月 金 門
鐟 : 一 大 日 曰 金
鐮 : 一 ｜ 丶 ノ 丷 广 ヨ 金
鐯 : ノ 土 ⺾ ⺹ 日 曰 金
鐱 : 一 人 ㅅ 口 金
鐲 : 勹 ⺲ 虫 金
鐳 : 二 冖 田 金 雨
鐴 : 十 口 尸 立 辛 金
鐻 : 匕 卜 厂 虍 豕 金
鐿 : 心 日 立 金 音
鐽 : 丷 ⻌ 土 王 羊 金
鑃 : 冫 羽 金 隹
鑅 : 冖 木 火 金
鑈 : 一 ｜ ハ 冂 爻 金
鑊 : 又 ⺾ 金 隹
鑌 : 一 ノ ハ 宀 小 目 貝 金
鑕 : ハ 斤 目 貝 金
鑙 : 丶 ノ 匕 尢 日 曰 木 尤 禾 金
鑜 : ハ 冖 口 ⺌ 目 貝 金
鑟 : ハ 士 目 ⺲ 貝 金
鑡 : 一 人 凵 止 金
鑣 : 匕 广 比 ⺣ 金 鹿
鑨 : 一 乙 月 立 金 竜
鑫 : 金
鑭 : 丷 口 木 金 門
鑮 : 丶 二 冂 十 寸 ⺡ ⺾ 金
鑯 : 一 人 戈 金 非
鑱 : 乙 勹 匕 口 已 比 巴 色 金
鑲 : 一 ｜ 亠 口 衣 金
钄 : 丷 口 ⺾ 木 金 門
钃 : ｜ 丶 ノ 冫 勹 尸 ⺲ 虫 金
镸 : 一 ｜ 厶
镹 : 一 ｜ ノ 入 厶 久
镾 : 一 ｜ ハ 冂 厶 爻
閄 : 人 門
閈 : 一 十 干 門
閌 : 亠 几 門
閍 : 方 門
閎 : 一 ノ 厶 門
閝 : 丶 ㅅ マ 門
閞 : 厶 廾 門
閟 : ノ 心 門
閡 : ノ 亠 幺 玄 門
閦 : 人 ㅅ 門
閩 : 虫 門
閫 : 口 木 門
閬 : 丶 艮 門
閴 : ハ 目 貝 門
閶 : 日 門
閺 : 文 日 門
閽 : 日 氏 門
閿 : 冖 又 爪 門
闆 : 口 門
闈 : 口 門 韋
闉 : 土 西 門
闋 : 一 丶 ノ 大 門
闐 : 一 ハ 匕 十 目 貝 門
闑 : 木 目 自 門
闒 : ノ 二 冂 冫 日 羽 門
闓 : 丷 口 山 豆 門
闙 : 丶 口 尸 攵 門
闚 : 一 儿 大 目 見 門
闝 : ハ 攵 目 貝 門
闞 : 一 攵 耳 門
闟 : 一 ㅅ 冫 口 羽 門
闠 : 一 ｜ ハ 口 目 虫 貝 門
闤 : 一 口 ⺲ 衣 門
闦 : ｜ 丷 口 日 豆 門
阝 : ⻖
阞 : 力 ⻖
阢 : 一 儿 廾 ⻖
阤 : ｜ 乙 匕 ⻖ 也
阥 : ⻖ 水
阦 : ⻖ 火
阬 : 亠 几 ⻖
阱 : 一 廾 ⻖
阳 : ⻖ 日
阷 : 一 ⻖ 止
阸 : 一 丶 乙 尸 ⻖ 戸
阹 : 厶 土 ⻖
阺 : 丶 ⻖ 氏
阼 : 一 ｜ ノ ⻖
阽 : 卜 口 ⻖
陁 : 一 ｜ ノ 乙 匕 ⻖ 也
陒 : 勹 厂 已 ⻖
陔 : ノ 亠 幺 ⻖ 玄
陖 : ハ 厶 夂 ⻖
陗 : ⺌ ⻖ 月
陘 : 一 巛 工 ⻖
陡 : 土 ⻖ 走
陮 : ⻖ 隹
陴 : ノ 十 ⻖ 日 田
陻 : 土 ⻖ 西
陼 : ノ 土 ⻖ ⺹ 日 曰
陾 : 大 ⻖ 而
陿 : 人 匚 ⻖ 木
隁 : 匚 女 ⻖ 日
隂 : 一 ｜ ㅅ 厶 ⻖
隃 : 一 丶 ㅅ 冂 ⺉ ⻖ 月
隄 : ⻖ 日 疋
隉 : 土 工 ⻖ 臼
隑 : 丷 口 山 ⻖ 豆
隖 : ⻖ ⺣ 鳥
隚 : 冖 口 土 ⺌ ⻖
隝 : ⻖ ⺣ 鳥
隟 : 巛 ⻖ 日 木 田
隤 : 一 ｜ ハ 口 ⻖ 目 虫 貝
隥 : 丶 ノ 丷 口 ⻖ 豆
隦 : 十 口 尸 ⻖ 立 辛
隩 : ノ 冂 大 ⻖ 米
隮 : 亠 刀 ⻖ 氏 齊
隯 : 一 口 士 寸 工 ⻖
隳 : 一 ノ ㅅ 工 ⻖ 月 ⺣
隺 : 冖 隹
雊 : 勹 口 隹
雒 : 口 夂 隹
嶲 : ｜ 亅 山 隹
雘 : 一 ｜ 丶 冂 又 ⺾ 隹
雚 : 口 ⺾ 隹
雝 : 乙 口 巛 已 巴 隹
雞 : 大 幺 爪 隹
雟 : ハ 冂 口 屮 隹
雩 : 二 冖 勹 雨
雯 : 二 冖 文 雨
雱 : 二 冖 方 雨
雺 : 二 冖 マ 矛 雨
霂 : 二 冖 ⺡ 木 雨
霃 : ノ 乙 二 冖 尢 ⺡ 雨
霅 : 二 冖 言 雨
霉 : 一 ノ 二 冖 毋 母 雨
霚 : 二 冖 マ 攵 矛 雨
霛 : 二 冖 弓 雨
霝 : 二 冖 口 雨
霡 : 丶 二 冖 月 水 雨
霢 : 二 冖 厂 月 氏 雨
霣 : 二 ハ 冖 口 目 貝 雨
霨 : 二 冖 寸 小 尸 示 雨
霱 : 二 儿 ハ 冂 冖 マ 口 矛 雨
霳 : 一 二 冖 夂 ⻖ 生 雨
靁 : 二 冖 田 雨
靃 : 二 冖 隹 雨
靊 : 一 ｜ 二 丷 冖 口 山 豆 雨
靎 : 二 冖 ⺣ 金 雨 鳥
靏 : 二 冖 ⺣ 隹 雨 鳥
靕 : 一 ｜ 二 亠 冂 土 月 止 青
靗 : 一 二 亠 儿 土 ⺌ 月 青
靘 : 二 亠 土 月 青
靚 : 二 亠 儿 土 月 目 見 青
靛 : 二 亠 土 宀 月 疋 青
靣 : 一 ノ 口 囗
靧 : 一 ｜ ハ 口 目 虫 貝 面
靪 : 一 亅 十 口 廾 革
靮 : 一 丶 勹 十 口 廾 革
靳 : 十 口 廾 斤 革
靶 : 乙 十 口 已 廾 巴 革
靷 : ｜ 十 口 廾 弓 革
靸 : 丶 十 乃 口 廾 及 革
靻 : 一 十 口 廾 目 革
靽 : ｜ 二 ハ 丷 十 口 廾 革
靿 : 力 十 口 幺 廾 革
鞀 : 刀 十 口 廾 革
鞉 : 丶 ノ 儿 冫 十 口 廾 革
鞕 : 一 丶 ノ 十 口 廾 日 革
鞖 : 十 口 女 廾 爪 革
鞗 : ｜ ⺅ 十 口 夂 廾 革
鞙 : 十 口 廾 月 革
鞚 : 儿 ハ 十 口 宀 工 廾 革
鞞 : ノ 十 口 廾 田 革
鞟 : 亠 十 口 子 廾 革
鞢 : 一 ｜ 十 口 廾 木 世 革
鞬 : ｜ 二 十 口 廴 廾 ヨ 聿 革
鞮 : 十 口 廾 日 疋 革
鞱 : 十 口 廾 爪 臼 革
鞲 : 一 ｜ 二 冂 十 口 廾 月 革
鞵 : 十 口 大 幺 廾 爪 革
鞶 : 一 ｜ 丶 冂 几 十 又 口 廾 殳 舟 革
鞸 : 一 ｜ 二 十 口 廾 日 田 革
鞹 : 亠 十 口 子 廾 ⻏ 革
鞺 : 冖 十 口 土 ⺌ 廾 革
鞼 : 一 ｜ ハ 十 口 廾 目 虫 貝 革
鞾 : 一 ｜ 二 十 口 廾 ⺾ 革
鞿 : 人 十 口 幺 廾 戈 革
韁 : 一 十 口 廾 田 革
韄 : 十 又 口 廾 ⺾ 隹 革
韅 : 十 口 幺 廾 日 曰 ⺣ 革
韇 : ハ 十 口 士 廾 目 ⺲ 貝 革
韉 : 一 ｜ 勹 十 口 广 廾 ⺾ ⺣ 革
韊 : 丷 十 口 廾 ⺾ 木 門 革
韌 : ノ 刀 口 韋
韍 : 又 口 弋 韋
韎 : 一 口 木 韋
韐 : 一 ㅅ 口 韋
韑 : 一 儿 口 ⺌ 韋
韔 : 口 長 韋
韗 : 冖 口 車 韋
韘 : 一 ｜ 口 木 世 韋
韙 : 口 日 疋 韋
韝 : 一 ｜ 二 冂 口 月 韋
韞 : 人 口 日 皿 韋
韠 : 一 ｜ 二 口 日 田 韋
韛 : ｜ ノ 二 厂 口 ⺾ 用 韋
韡 : 一 ｜ 二 口 ⺾ 韋
韤 : 人 口 ⺾ 戈 ⺲ 韋
韯 : 一 十 土 戈 非
韱 : 一 人 戈 非
韴 : 一 ｜ 冂 巾 日 立 音
韷 : ｜ 凵 日 立 音
韸 : 一 ｜ 二 夂 日 立 音
韺 : 口 大 ⺾ 日 立 音
頇 : 一 ハ 十 干 目 貝 頁
頊 : ハ 王 目 貝 頁
頙 : 一 ハ 止 目 貝 頁
頍 : ハ 十 又 支 目 貝 頁
頎 : ハ 斤 目 貝 頁
頔 : ｜ ハ 日 田 目 貝 頁
頖 : ｜ ノ 二 ハ 丷 目 貝 頁
頜 : 一 ㅅ ハ 口 目 貝 頁
頞 : ハ 女 宀 目 貝 頁
頠 : ハ 勹 卩 厂 目 貝 頁
頣 : ハ 匚 目 臣 貝 頁
頦 : ノ 亠 ハ 幺 玄 目 貝 頁
頫 : 丶 ノ 儿 ハ 冫 目 貝 頁
頮 : ハ 廾 水 目 貝 頁
頯 : 丶 ハ 夕 廾 目 貝 頁
頰 : 人 ハ 木 目 貝 頁
頲 : ノ ハ 士 廴 王 目 貝 頁
頳 : ハ 土 目 貝 赤 頁
頵 : ノ ハ 口 ヨ 目 貝 頁
頥 : ｜ ハ 匚 目 臣 貝 頁
頾 : ハ 匕 彡 止 目 貝 頁
顄 : ハ 凵 水 目 貝 頁
顇 : 亠 人 ハ 十 目 貝 頁
顊 : ｜ ノ ハ 十 口 目 貝 頁
顑 : 一 ノ ハ 厂 口 戈 目 貝 頁
顒 : ｜ ハ 冂 厶 日 田 目 ⽱ 貝 頁
顓 : ハ 山 目 而 貝 頁
顖 : 丶 ノ ハ 口 心 目 貝 頁
顗 : ハ 丷 口 山 目 豆 貝 頁
顙 : ハ 又 木 目 貝 頁
顚 : ハ 匕 目 貝 頁
顢 : 一 ｜ 入 ハ 冂 凵 目 貝 頁
顣 : 一 ノ ハ 卜 厂 小 戈 目 貝 頁
顥 : 亠 ハ 口 小 日 目 貝 頁
顦 : ハ ⺣ 目 貝 隹 頁
顪 : 一 ノ ハ 厂 小 戈 止 目 貝 頁
顬 : 二 ハ 冖 目 而 貝 雨 頁
颫 : 一 ノ 冂 大 虫 風
颭 : ノ 冂 卜 口 虫 風
颮 : ノ 冂 勹 已 虫 風
颰 : 丶 ノ 冂 又 弋 虫 風
颴 : 一 ノ 冂 疋 虫 風
颷 : ノ 冂 火 虫 風
颸 : ノ 冂 心 田 虫 風
颺 : 一 ノ 冂 勹 日 勿 虫 風
颻 : 丶 ノ 冂 凵 夕 山 爪 缶 虫 風
颿 : ノ 冂 虫 風 馬
飂 : ノ ㅅ 冂 冫 彡 羽 虫 風
飅 : 一 ｜ ノ 冂 口 田 虫 風
飈 : ノ 冂 火 虫 風
飌 : ノ 冂 口 ⺾ 虫 隹 風
飡 : 一 丶 ㅅ 冫 艮
飣 : 一 丶 亅 ㅅ 厶 日
飥 : 一 丶 ノ 乙 ㅅ 厶 日
飦 : 一 丶 ㅅ 十 厶 干 日 曰
飧 : 一 丶 ㅅ 夕 艮
飪 : 一 丶 ノ ㅅ 卜 士 日
飳 : 一 丶 亠 ㅅ 厶 土 日 王
飶 : 丶 ノ ㅅ 厶 心 日 曰
餂 : 一 丶 ㅅ 厶 口 日 舌
餇 : 一 丶 ㅅ 冂 厶 口 日 曰
餈 : 一 丶 人 ㅅ 冫 勹 欠 艮
餑 : 一 丶 ㅅ 冖 十 厶 子 日
餕 : 一 丶 ㅅ 儿 ハ 厶 夂 日
餖 : 一 丶 ㅅ 丷 厶 口 日 豆
餗 : 一 丶 ㅅ 厶 口 日 木
餚 : 一 丶 ノ ㅅ 厶 日 月
餛 : 一 丶 ㅅ 匕 厶 日 比
餜 : 一 丶 ㅅ 厶 日 木 田
餟 : 丶 ㅅ 厶 又 日 曰
餢 : 丶 ㅅ 厶 口 日 立
餦 : 丶 ㅅ 厶 日 長
餧 : 一 丶 ノ ㅅ 厶 女 日 木 禾
餫 : 丶 ㅅ 冖 厶 日 車
餱 : 一 丶 ノ ⺅ ㅅ 厶 ユ 大 日 矢
餲 : 一 丶 人 ㅅ 勹 厶 日
餳 : 一 丶 ノ ㅅ 勹 厶 日 勿
餴 : 丶 ㅅ 十 厶 大 廾 日 曰
餵 : 一 丶 ㅅ 厶 日 田 衣
餹 : ｜ 丶 ㅅ 厶 口 广 ヨ 日 曰
餺 : 一 丶 ㅅ 十 厶 寸 日 月
餻 : 一 丶 ㅅ 丷 厶 日 ⺣ 王
餼 : 一 丶 ㅅ 厶 日 气 米
饀 : 一 丶 ㅅ 厶 日 爪 臼
饁 : 一 丶 ㅅ 厶 土 日 皿
饆 : 一 ｜ 丶 ㅅ 厶 日 田
饇 : 丶 ㅅ 匚 厶 口 日 曰
饈 : 一 ｜ 丶 ノ ㅅ 丷 厶 ヨ 日 王 羊
饍 : 一 丶 丷 厶 口 日 王 羊
饎 : 一 丶 ㅅ 丷 十 厶 口 士 日 豆
饔 : 一 丶 亠 ㅅ 幺 艮 隹
饘 : 一 丶 亠 ㅅ 厶 口 囗 日
饙 : 丶 ㅅ ハ 十 厶 ⺾ 日 曰 目 貝
饛 : 一 丶 ㅅ 冖 厶 ⺾ 日 曰 豕
饜 : 一 丶 ㅅ 厂 大 日 月 犬 艮
饞 : 一 丶 乙 ㅅ 勹 匕 厶 口 已 日 比 巴 色
饟 : 一 ｜ 丶 二 亠 ㅅ 厶 口 日 衣
饠 : 一 丶 ㅅ 厶 小 幺 日 ⺲ 糸 隹
馛 : ノ 又 弋 日 曰 木 禾
馝 : ノ 心 日 曰 木 禾
馟 : ノ 子 日 曰 木 爪 禾
馦 : 一 ｜ 丶 ノ 丷 ヨ 日 木 禾
馰 : 丶 勹 馬
馱 : 大 馬
馲 : 一 ノ 乙 馬
馵 : 廾 馬
馹 : 日 馬
馺 : 丶 乃 及 馬
馽 : ｜ 口 馬
馿 : 一 丶 尸 戸 馬
駃 : 人 ユ 馬
駉 : 冂 口 馬
駓 : 一 ｜ 丶 ノ 馬
駔 : 一 目 馬
駙 : ⺅ 寸 馬
駚 : 口 大 馬
駜 : ノ 心 馬
駞 : 一 ｜ ノ 乙 匕 也 馬
駧 : 一 冂 口 馬
駪 : ノ 儿 土 馬
駫 : 一 儿 ⺌ 馬
駬 : 耳 馬
駰 : 囗 大 馬
駴 : 廾 戈 馬
駵 : 口 廾 馬
駹 : 丶 九 彡 馬
駽 : 口 月 馬
駾 : 儿 丷 口 馬
騂 : 十 立 辛 馬
騃 : 一 ノ 厶 大 矢 馬
騄 : ヨ 水 馬
騋 : 人 木 馬
騌 : 二 宀 小 示 馬
騐 : 一 丶 ㅅ 心 馬
騑 : 非 馬
騖 : マ 攵 矛 馬
騞 : 一 ｜ 二 口 石 馬
騠 : 日 疋 馬
騢 : 一 ｜ 又 口 馬
騣 : 丶 ノ 儿 ハ 凵 夂 馬
騤 : 一 丶 ノ 大 馬
騧 : 冂 口 馬
騭 : ノ 小 ⻖ 止 馬
騮 : ノ 刀 厶 田 馬
騳 : 馬
騵 : 厂 小 日 白 馬
騶 : 勹 屮 馬
騸 : 一 丶 ノ 冫 尸 戸 羽 馬
驇 : 丶 ハ 九 土 馬
驁 : 一 ｜ ノ 亅 二 土 士 攵 方 馬
驄 : ノ 口 夂 心 馬
驊 : 一 ｜ 二 ⺾ 馬
驋 : 丶 ノ 几 又 弓 殳 馬
驌 : ｜ ヨ 爿 片 馬
驎 : 夕 米 舛 馬
驑 : 一 ｜ 田 馬
驔 : 十 日 曰 西 馬
驖 : 十 口 土 戈 王 馬
驝 : 冖 口 士 木 石 馬
骪 : 丶 冂 冖 几 月 骨
骬 : 亅 二 冂 冖 月 骨
骮 : 冂 冖 弋 月 骨
骯 : 亠 冂 冖 几 月 骨
骲 : 冂 冖 勹 已 月 骨
骴 : 冂 冖 匕 月 止 骨
骵 : 一 冂 冖 月 木 骨
骶 : 一 丶 冂 冖 月 氏 骨
骹 : 亠 冂 冖 月 父 骨
骻 : 二 冂 冖 勹 大 月 骨
骾 : 一 丶 ノ 冂 冖 日 月 骨
骿 : 一 丷 冂 冖 廾 月 骨
髁 : 冂 冖 月 木 田 骨
髃 : ｜ 冂 冖 厶 日 月 田 ⽱ 骨
髆 : 丶 冂 冖 十 寸 日 月 田 骨
髈 : 亠 丷 冂 冖 方 月 立 骨
髎 : ノ ㅅ 冂 冖 冫 彡 月 羽 骨
髐 : 一 儿 冂 冖 土 月 骨
髒 : 一 冂 冖 匕 夕 廾 ⺾ 月 歹 骨
髕 : 一 ノ ハ 冂 冖 宀 小 月 目 貝 骨
髖 : 丶 儿 冂 冖 宀 ⺾ 月 目 見 骨
髗 : 冂 冖 匕 卜 厂 月 田 皿 虍 骨
髛 : 亠 冂 九 口 尸 高
髜 : ノ 亠 冂 口 廾 日 高
髠 : 几 彡 長 髟
髤 : 彡 木 長 髟
髥 : 二 冂 彡 月 長 髟
髧 : ノ 乙 冖 尢 彡 長 髟
髩 : 一 ｜ 亅 彡 長 髟
髬 : ｜ 丶 ノ 二 彡 長 髟
髲 : ノ 十 厂 又 彡 支 長 髟
髳 : マ 彡 矛 長 髟
髵 : 彡 而 長 髟
髹 : ⺅ 彡 木 長 髟
髺 : 口 彡 舌 長 髟
髽 : 人 土 彡 長 髟
髿 : ノ 小 彡 ⺡ 長 髟
鬀 : ｜ ノ 丷 弓 彡 長 髟
鬁 : ノ ⺉ 彡 木 禾 長 髟
鬂 : 一 ハ 彡 斤 長 髟
鬃 : 二 宀 小 彡 示 長 髟
鬄 : ノ 勹 彡 日 曰 勿 長 髟
鬅 : 彡 月 長 髟
鬈 : 一 丶 ノ 丷 大 已 彡 長 髟
鬉 : 丶 ノ 儿 ハ 凵 夂 彡 長 髟
鬋 : 一 丶 丷 冂 ⺉ 彡 月 長 髟
鬌 : 一 ノ 工 彡 月 長 髟
鬍 : 十 口 彡 月 長 髟
鬎 : ⺉ 口 彡 木 長 髟
鬐 : ノ 匕 土 彡 ⺹ 日 長 髟
鬒 : 一 ハ 匕 十 彡 目 貝 長 髟
鬖 : ㅅ 厶 彡 長 髟
鬙 : ｜ ハ 丷 口 彡 日 長 髟
鬛 : 丶 ノ 乙 口 川 彡 長 髟
鬜 : 彡 月 長 門 髟
鬠 : 一 ｜ ㅅ 丷 口 彡 日 長 髟
鬦 : ｜ 亅 斗 王
鬫 : ｜ 亅 ユ 工 攵 王 耳
鬭 : ｜ 亅 口 斤 王
鬳 : 儿 丷 冂 匕 卜 厂 口 虍 鬲
鬴 : 丶 儿 丷 冂 十 口 月 鬲
鬵 : 儿 丷 冂 口 无 鬲
鬷 : 丶 ノ 儿 ハ 丷 冂 凵 口 夂 鬲
鬹 : 一 儿 丷 冂 口 大 目 見 鬲
鬺 : 一 ノ 儿 丷 冂 勹 口 日 曰 勿 鬲
鬽 : 儿 匕 厶 彡 田 鬼
魈 : 儿 匕 厶 小 ⺌ 月 田 鬼
魋 : 儿 匕 厶 田 隹 鬼
魌 : ｜ 二 儿 ハ 匕 厶 甘 田 鬼
魕 : 人 儿 匕 厶 幺 戈 田 鬼
魖 : 一 ｜ 丶 ノ 儿 匕 卜 厂 厶 田 虍 鬼
魗 : 一 儿 匕 厶 口 士 寸 工 田 鬼
魛 : 刀 ⺣ 田 魚
魞 : 入 ⺣ 田 魚
魡 : 丶 勹 ⺣ 田 魚
魣 : 一 亅 マ ⺣ 田 矛 魚
魥 : 丶 乃 及 ⺣ 田 魚
魦 : ノ 小 ⺣ 田 魚
魨 : ノ 乙 凵 ⺣ 屯 田 魚
魪 : ｜ ノ ㅅ ⺣ 田 魚
魫 : ノ 乙 冖 尢 ⺣ 田 魚
魬 : 厂 又 ⺣ 田 魚
魭 : 二 儿 ⺣ 元 田 魚
魮 : 匕 比 ⺣ 田 魚
魳 : 一 ｜ 冂 巾 ⺣ 田 魚
魵 : ハ 刀 ⺣ 田 魚
魷 : 丶 尢 ⺣ 尤 田 魚
魸 : ⺣ 片 田 魚
魹 : ノ 乙 二 手 ⺣ 田 魚
魿 : 丶 ㅅ マ ⺣ 田 魚
鮀 : 匕 宀 ⺣ 田 魚
鮄 : 廾 弓 ⺣ 田 魚
鮅 : ノ 心 ⺣ 田 魚
鮆 : 匕 止 ⺣ 田 魚
鮇 : 一 木 ⺣ 田 魚
鮉 : 刀 口 ⺣ 田 魚
鮊 : 日 ⺣ 田 白 魚
鮋 : ｜ 日 ⺣ 田 魚
鮍 : ノ 十 又 支 ⺣ 田 魚
鮏 : ⺣ 生 田 魚
鮐 : 厶 口 ⺣ 田 魚
鮔 : 匚 口 ⺣ 田 魚
鮚 : 口 士 ⺣ 田 魚
鮝 : 一 ハ 丷 大 ⺣ 田 魚
鮞 : ⺣ 田 而 魚
鮦 : 一 冂 口 ⺣ 田 魚
鮧 : 大 弓 ⺣ 田 魚
鮩 : 一 丷 廾 ⺣ 田 魚
鮬 : 二 勹 大 ⺣ 田 魚
鮰 : 口 囗 ⺣ 田 魚
鮱 : ノ 匕 土 ⺹ ⺣ 田 魚
鮲 : 丶 ⺅ 大 ⺣ 犬 田 魚
鮷 : ｜ ノ 丷 弓 ⺣ 田 魚
鮸 : 一 ｜ 儿 勹 口 ⺣ 田 免 魚
鮻 : 儿 ハ 厶 夂 ⺣ 田 魚
鮼 : 冖 又 ヨ ⺣ 田 魚
鮾 : 女 ⺣ 爪 田 魚
鮿 : 乙 ⺣ 田 耳 魚
鯁 : 一 丶 ノ 日 ⺣ 田 魚
鯇 : 二 儿 宀 ⺣ 元 田 魚
鯈 : ｜ ⺅ 夂 ⺣ 田 魚
鯎 : ノ 亅 厂 戈 ⺣ 田 魚
鯐 : 土 止 ⺣ 田 走 魚
鯗 : 一 丶 ノ 二 丷 ⺣ 王 田 魚
鯘 : ノ 女 木 ⺣ 田 禾 魚
鯝 : 十 口 囗 ⺣ 田 魚
鯟 : 日 木 ⺣ 田 魚
鯥 : 儿 ハ 土 ⺣ 田 魚
鯧 : 日 ⺣ 田 魚
鯪 : 儿 ハ 土 夂 ⺣ 田 魚
鯫 : 又 ⺣ 田 耳 魚
鯯 : 冂 ⺉ ⺣ 牛 田 魚
鯳 : 一 丶 广 氏 ⺣ 田 魚
鯷 : 日 ⺣ 田 疋 魚
鯸 : 一 ノ ⺅ ユ 大 ⺣ 田 矢 魚
鯹 : 日 曰 ⺣ 生 田 魚
鯺 : ノ 土 ⺹ 日 ⺣ 田 魚
鯽 : 匕 卩 厶 日 ⺣ 田 白 魚
鯿 : 一 ｜ 丶 亅 冂 尸 戸 ⺣ 田 冊 魚 廾
鰀 : ノ 二 又 ⺣ 爪 田 魚
鰂 : ハ ⺉ ⺣ 田 目 貝 魚
鰋 : 匚 女 日 ⺣ 田 魚
鰏 : 一 口 ⺣ 田 魚
鰑 : 一 ノ 勹 日 曰 ⺣ 勿 田 魚
鰖 : 一 ノ 工 月 ⺣ 田 魚
鰘 : 一 厶 土 宀 ⺣ 田 至 魚
鰙 : 一 ノ 口 ⺾ ⺣ 田 魚
鰚 : 一 宀 日 ⺣ 田 魚
鰜 : 一 ｜ ノ 丷 ヨ ⺣ 田 魚
鰞 : ⺣ 田 魚 鳥
鰢 : ⺣ 田 馬 魚
鰣 : 土 寸 日 ⺣ 田 魚
鰦 : 一 丷 幺 ⺣ 田 魚
鰧 : 一 丶 ハ 丷 冂 大 月 ⺣ 田 魚
鰨 : 冫 日 曰 ⺣ 田 羽 魚
鰩 : 丶 凵 夕 山 ⺣ 爪 田 缶 魚
鰪 : 厶 土 ⺣ 田 皿 魚
鰱 : ⻌ ⺣ 田 車 魚
鰵 : 一 ノ 攵 ⺣ 毋 田 母 魚
鰶 : 丶 二 夕 小 ⺣ 田 示 魚
鰷 : 一 ｜ ⺅ 夂 小 攵 木 ⺣ 田 魚
鰽 : 一 ｜ 日 曰 ⺣ 田 魚
鱁 : 一 丶 ノ ⻌ ⺨ ⺣ 田 豕 魚
鱃 : 一 ｜ ノ 二 丷 ヨ ⺣ 王 田 羊 魚
鱄 : 一 十 厶 寸 日 ⺣ 田 虫 魚
鱅 : ｜ 二 冂 广 ヨ 月 ⺣ 田 聿 魚
鱉 : ｜ ハ 丷 冂 巾 攵 ⺣ 田 魚
鱊 : 儿 ハ 冂 マ 口 ⺣ 田 矛 魚
鱎 : ノ 冂 口 大 ⺣ 田 魚
鱏 : 一 冂 凵 十 日 ⺣ 田 西 魚
鱐 : ｜ ヨ ⺣ 爿 片 田 魚
鱓 : 十 口 日 ⺣ 田 魚
鱔 : 一 丷 口 ⺣ 王 田 羊 魚
鱖 : 一 人 丷 勹 厂 屮 欠 ⺣ 田 魚
鱘 : 口 寸 工 ヨ ⺣ 田 魚
鱛 : ｜ ハ 丷 口 日 ⺣ 田 魚
鱝 : ハ 十 ⺾ ⺣ 田 目 貝 魚
鱞 : 一 口 ⺣ 田 ⺲ 衣 魚
鱟 : 一 ｜ 冖 ヨ ⺣ 爻 田 魚
鱣 : 一 亠 口 囗 日 ⺣ 田 魚
鱩 : 二 冖 ⺣ 田 雨 魚
鱪 : ノ 土 ⺹ 日 ⺣ 田 魚
鱜 : 丶 匕 厶 幺 ⻏ 日 ⺣ 田 白 魚
鱫 : 冖 夂 心 ⺣ 爪 田 魚
鱨 : 冖 匕 口 ⺌ 日 ⺣ 田 魚
鱮 : 一 ｜ 亠 ハ ヨ ⺣ 田 魚
鱰 : ノ 土 ⺹ 日 ⺣ 田 ⺲ 魚
鱲 : 丶 ノ 乙 口 川 巛 ⺣ 田 魚
鱵 : 一 ノ 厂 口 戈 ⺣ 田 竹 魚
鱷 : 口 ⺣ 王 田 魚
鱻 : ⺣ 田 魚
鳦 : 乙 ⺣ 鳥
鳲 : 尸 ⺣ 鳥
鳷 : 十 又 支 ⺣ 鳥
鳹 : 丶 ㅅ ⺣ 鳥
鴋 : 方 ⺣ 鳥
鴂 : 人 ユ ⺣ 鳥
鴑 : 又 女 ⺣ 鳥
鴗 : ⺣ 立 鳥
鴘 : 厶 廾 ⺣ 鳥
鴜 : 匕 止 ⺣ 鳥
鴝 : 勹 口 ⺣ 鳥
鴞 : 一 勹 口 ⺣ 鳥
鴯 : ⺣ 而 鳥
鴰 : 口 ⺣ 舌 鳥
鴲 : 匕 日 ⺣ 鳥
鴳 : 女 宀 ⺣ 鳥
鴴 : 彳 ⺣ 行 鳥
鴺 : 大 弓 ⺣ 鳥
鴼 : 口 夂 ⺣ 鳥
鵅 : 口 夂 ⺣ 鳥
鴽 : 口 女 ⺣ 鳥
鵂 : ⺅ 木 ⺣ 鳥
鵃 : 一 ｜ 丶 冂 ⺣ 舟 鳥
鵇 : 一 ノ 十 干 ⺣ 鳥
鵊 : 人 大 ⺣ 鳥
鵓 : 冖 十 子 ⺣ 鳥
鵔 : ハ 厶 夂 ⺣ 鳥
鵟 : ⺨ ⺣ 王 鳥
鵣 : 口 木 ⺣ 鳥
鵢 : ⺣ 身 鳥
鵥 : ｜ ノ 二 丷 ⺉ ⺣ 鳥
鵩 : 丶 冂 又 尸 月 ⺣ 鳥
鵪 : ｜ 大 日 ⺣ 鳥
鵫 : 十 卜 日 ⺣ 鳥
鵰 : ｜ 二 冂 口 土 ⺣ 鳥
鵶 : 一 ｜ ⺣ 鳥
鵷 : 卩 夕 宀 ⺣ 鳥
鵻 : ⺣ 隹 鳥
鵼 : 儿 ハ 宀 工 ⺣ 鳥
鵾 : 匕 日 比 ⺣ 鳥
鶃 : 儿 ⺣ 臼 鳥
鶄 : 一 ｜ 冂 土 月 ⺣ 鳥
鶆 : 人 木 ⺣ 鳥
鶊 : 人 广 ヨ ⺣ 鳥
鶍 : ノ 勹 日 ⺣ 勿 鳥
鶎 : 二 宀 小 ⺣ 示 鳥
鶒 : 力 口 木 ⺣ 鳥
鶓 : ⺾ ⺣ 田 鳥
鶕 : 日 曰 ⺣ 立 鳥
鶖 : ノ 木 火 ⺣ 禾 鳥
鶗 : 日 曰 ⺣ 疋 鳥
鶘 : 十 口 月 ⺣ 鳥
鶡 : 人 勹 日 ⺣ 鳥
鶪 : 丶 大 ⺣ 犬 目 鳥
鶬 : 一 丶 ノ ㅅ 口 日 ⺣ 鳥
鶮 : 亠 冂 口 ⺣ 高 鳥
鶱 : 一 ｜ 丶 ノ 二 宀 ⺣ 鳥
鶵 : 勹 屮 ⺣ 鳥
鶹 : ノ 刀 厶 ⺣ 田 鳥
鶼 : 一 ｜ 丶 ノ 丷 ヨ ⺣ 鳥
鶿 : 一 丷 幺 ⺣ 鳥
鷃 : 女 宀 日 ⺣ 鳥
鷇 : 一 冖 几 又 士 殳 ⺣ 鳥
鷉 : 儿 几 匕 卜 厂 ⺣ 虍 鳥
鷊 : 丷 冂 口 ⺣ 鬲 鳥
鷔 : 士 攵 方 ⺣ 鳥
鷕 : 口 ⺣ 隹 鳥
鷖 : 一 ノ 几 匚 又 大 殳 ⺣ 矢 鳥
鷗 : 匚 口 ⺣ 鳥
鷚 : ノ ㅅ 冫 彡 ⺣ 羽 鳥
鷞 : 大 ⺣ 爻 鳥
鷟 : 一 ノ 大 方 ⺣ 矢 鳥
鷠 : ⺣ 田 魚 鳥
鷥 : 小 幺 ⺣ 糸 鳥
鷧 : 丷 冖 口 士 ⺣ 豆 鳥
鷩 : ｜ ハ 丷 冂 巾 攵 ⺣ 鳥
鷫 : ｜ ヨ ⺣ 爿 片 鳥
鷮 : ノ 冂 口 大 ⺣ 鳥
鷰 : 一 ｜ 凵 匕 口 ⺣ 鳥
鷳 : 月 ⺣ 門 鳥
鷴 : 木 ⺣ 門 鳥
鷾 : 心 日 ⺣ 立 音 鳥
鸊 : 十 口 尸 ⺣ 立 辛 鳥
鸂 : 大 幺 ⺡ ⺣ 爪 鳥
鸇 : 一 亠 口 囗 日 ⺣ 鳥
鸎 : ハ ⺣ 目 貝 鳥
鸐 : 冫 ⺣ 羽 隹 鳥
鸑 : 丶 大 ⺨ ⺣ 犬 言 鳥
鸒 : 一 ｜ 丶 ノ ヨ ⺣ 鳥
鸕 : 匕 卜 厂 ⺣ 田 皿 虍 鳥
鸖 : 二 冖 ⺣ 隹 雨 鳥
鸙 : 一 ｜ 亅 ㅅ 冂 口 廾 ⺣ 冊 鳥 龠
鸜 : ⺣ 目 隹 鳥
鸝 : 一 丶 冂 匕 广 比 ⺣ 鳥 鹿
鹺 : 一 ノ 二 丷 十 囗 工 王 羊 鹵
鹻 : 一 ｜ 丶 ノ 丷 十 囗 ヨ 鹵
鹼 : 一 人 ㅅ 十 口 囗 鹵
麀 : 匕 广 比 鹿
麂 : 几 匕 广 比 鹿
麃 : 匕 广 比 ⺣ 鹿
麄 : ハ 刀 匕 广 比 鹿
麅 : 勹 匕 已 广 比 鹿
麇 : ノ 匕 广 木 比 禾 鹿
麎 : 亠 匕 厂 广 比 衣 辰 鹿
麏 : ノ 匕 口 广 ヨ 比 鹿
麖 : 亠 匕 口 小 广 比 鹿
麘 : ノ 匕 广 日 曰 木 比 禾 鹿
麛 : 匕 广 弓 比 耳 鹿
麞 : 匕 十 广 日 比 立 音 鹿
麤 : 匕 广 比 鹿
麨 : 十 ノ 人 夂 小 木
麬 : 十 ノ 人 十 又 夂 支 木
麮 : 十 人 厶 土 夂 木
麯 : 十 ｜ 人 夂 日 木
麰 : 十 人 厶 夂 木 牛
麳 : 十 人 夂 木
麴 : 十 人 勹 夂 木 米
麵 : 十 人 夂 木 面
黆 : ノ 乙 ハ 冖 尢 田 黄
黈 : 丶 ハ 王 田 黄
黋 : 一 儿 ハ ⺌ 田 黄
黕 : ノ 乙 丷 冖 口 土 尢 ⺣ 里 黒
黟 : 丷 口 土 夕 ⺣ 里 黒
黤 : 乙 丷 口 土 大 日 ⺣ 里 奄 黒
黧 : ノ 丷 勹 口 土 木 ⺣ 禾 里 黒
黬 : 一 ノ 丷 厂 口 土 戈 ⺣ 里 黒
黭 : 一 ㅅ 丷 口 土 廾 ⺣ 里 黒
黮 : 一 ｜ 儿 ハ 丷 匚 口 土 ⺣ 甘 里 黒
黰 : 一 ハ 丷 匕 十 口 土 ⺣ 目 貝 里 黒
黱 : 一 丷 口 土 大 月 ⺣ 里 黒
黲 : ㅅ 丷 厶 口 土 彡 ⺣ 里 黒
黵 : ハ 丷 勹 厂 口 土 ⺣ 言 里 黒
黸 : 丷 匕 卜 厂 口 土 ⺣ 田 皿 虍 里 黒
黿 : 二 儿 元 黽
鼂 : 一 日 黽
鼃 : 土 黽
鼉 : 一 口 田 黽
鼏 : 一 ｜ 冖 爿 片 目 鼎
鼐 : 一 ｜ 乃 爿 片 目 鼎
鼑 : 一 ｜ 卜 爿 片 目 鼎
鼒 : 一 ｜ ノ 亅 爿 片 目 鼎
鼔 : 丷 十 卜 又 口 士 支 豆 鼓
鼖 : 丷 十 又 口 士 廾 ⺾ 支 豆 鼓
鼗 : 丶 ノ 儿 丷 冫 十 又 口 士 支 豆 鼓
鼙 : ノ 丷 十 又 口 士 支 日 白 豆 鼓
鼚 : 丷 十 又 口 士 支 豆 長 鼓
鼛 : 丷 十 卜 又 口 士 夂 支 豆 鼓
鼟 : 丶 ノ 丷 十 又 口 士 支 豆 鼓
鼢 : ハ 刀 臼 鼠
鼦 : 刀 口 臼 鼠
鼪 : 生 臼 鼠
鼫 : 口 石 臼 鼠
鼯 : 一 二 口 五 臼 鼠
鼱 : 二 亠 土 月 臼 青 鼠
鼲 : 冖 臼 車 鼠
鼴 : 匚 女 日 臼 鼠
鼷 : 大 幺 爪 臼 鼠
鼹 : 女 宀 日 臼 鼠
鼺 : 田 臼 鼠
鼼 : ｜ 廾 田 目 自 鼻
鼽 : 九 廾 田 目 自 鼻
鼿 : 一 儿 廾 田 目 自 鼻
齁 : 勹 口 廾 田 目 自 鼻
齃 : 人 勹 廾 日 曰 田 目 自 鼻
齄 : 一 廾 日 曰 木 田 目 自 鼻
齅 : 丶 大 廾 犬 田 目 自 鼻
齆 : 乙 口 巛 已 廾 ⻏ 巴 田 目 自 鼻
齇 : 一 匕 卜 厂 廾 田 目 自 虍 鼻
齓 : 一 乙 人 凵 止 歯
齕 : 一 ノ 乙 人 凵 止 歯
齖 : 一 人 凵 止 牙 歯
齗 : 一 人 凵 斤 止 歯
齘 : 一 ｜ ノ 人 ㅅ 凵 止 歯
齚 : 一 ｜ ノ 人 凵 止 歯
齝 : 一 ㅅ 凵 厶 口 止 歯
齞 : 一 人 ハ 凵 口 止 歯
齨 : 一 人 凵 止 臼 歯
齩 : 一 亠 人 凵 止 父 歯
齭 : 一 ノ 人 凵 斤 止
齮 : 一 亅 人 凵 口 大 止 歯
齯 : 一 人 儿 凵 止 臼 歯
齰 : 一 ｜ 二 人 凵 日 止 歯
齱 : 一 人 凵 又 止 耳 歯
齳 : 一 人 冖 凵 止 車 歯
齵 : 一 人 冂 凵 厶 日 止 田 ⽱ 歯
齺 : 一 人 凵 勹 屮 止 歯
齽 : 一 二 人 凵 小 木 止 示 歯
龏 : 一 乙 廾 月 立 竜
龐 : 一 乙 广 月 立 竜
龑 : 一 乙 大 月 立 竜
龒 : 一 乙 二 小 月 示 立 竜
龔 : 一 ｜ 乙 二 ハ 月 立 竜
龖 : 一 乙 月 立 竜
龗 : 一 乙 二 冖 口 月 立 雨 竜
龞 : 一 ｜ 丶 ノ 乙 ハ 丷 冂 勹 巾 ヨ 攵
龡 : 一 ｜ 亅 人 ㅅ 冂 勹 口 廾 欠 冊 龠
龢 : 一 ｜ ノ 亅 ㅅ 冂 口 廾 木 禾 冊 龠
龣 : 一 ｜ 亅 ㅅ 冂 口 廾 ヨ 水 冊 龠
龥 : 一 ｜ 亅 ㅅ ハ 冂 口 廾 目 冊 貝 頁 龠